OLGA       : STUART     MALDONADO  ASHLEE     VICKI     
ROB        : FARLEY    
DORIS      : MARTHA     WILKINSON  RANDALL    BRIDGET   
WILLARD    : DELANEY    DICK       VARGAS    
COLON      : THELMA     TUCKER     DONALD    
MAVIS      : ANTONE     MERCEDES   NICHOLS    WOODWARD  
LANDON     : JILL       ROBBINS    NADINE     HUNT      
KATHERINE  : CASTILLO   RIOS       DAPHNE     BUDDY      MANNING    STRONG    
PAGE       : NICOLE     DARYL      SHEPHERD   PARRISH    ENGLISH   
HOOPER     : MARCELINO  MERLIN     TANIA     
OLIVER     : OCTAVIO    ROSALIE    SETH      
CASTILLO   : KATHERINE  AGNES      DYER       SCOTTIE   
TRENTON    : RIOS       GABRIELA   NIELSEN    HEWITT     JOYNER    
RAMSEY     : MARISOL    HANNAH     IRWIN      LETICIA    DARRYL    
VILMA      : TOM        DONA       GREGORY    PETER      FLORENCE   ALFONZO    GOODWIN   
MCDONALD   : TEDDY      ELINOR    
PEARSON    : SANDOVAL   SETH       HAYDEN    
WALTON     : ODELL      RODGERS    NORRIS     CATHRYN    NIELSEN    DWIGHT    
CARLSON    : JOYCE      DELANEY    BARNETT    MOSLEY    
MARISOL    : RAMSEY     KNOX       IGNACIO    DENA       CANTU      DIXON      INA       
LESTER     : EVANGELINA MINNIE    
MANN       : SILVA      BUDDY      DICK      
PERRY      : JOHN       COMBS      ROBLES     JESSE      BONNER     HEWITT    
KATY       : CRISTINA   HOLMAN     ENGLAND    RICARDO    DAWN       WEAVER     RODRIQUEZ  TIMMY     
KATY       : COMPTON    MERCER     BRYANT    
MARK       : JAMAAL     HIRAM      JAIME      JESSIE    
ANTONE     : MAVIS      RIOS       ROCCO      ROXANNE   
JOHN       : PERRY      VELMA      BLANCHARD  DELMAR    
MAXWELL    : TIMOTHY    MERLE     
ANNA       : PRUITT     HURST     
LETITIA    : JORDAN     VICKY      JUANITA   
VALERIE    : MERCADO    ERICKA     DYLAN     
MCKAY      : SILAS      MIKE       MASSEY     ELIJAH    
PRINCE     : MIKE       LINDA     
LUCIEN     : NUNEZ      WEISS      ROSEMARY   ISIAH      TOWNSEND  
CHANEY     : ERIK      
GILMORE    : BUCKNER    ROBT       CINDY      EVANGELINE
LESLIE     : MCFADDEN   STACI      PHELPS    
MARION     : PATE       FLOSSIE    GINGER     ALISSA     ROBERTSON 
GLENN      : BLEVINS    TASHA      CONNER     WALLER     CAROL     
LEE        : LOIS       HARRELL    JAMEL     
HATFIELD   : ED         PUCKETT    SCHWARTZ  
CRYSTAL    : COPELAND   BRIAN      ORR        AUTUMN    
LUCILLE    : PICKETT    JAIME      DEVON      KANE      
PATE       : MARION     IRIS       MARYANNE  
MONICA     : REBEKAH    CHERI      ROYCE     
LENARD     : JUSTINE    BURTON     GILLESPIE  FRANCISCO 
RAMIRO     : KARYN      ENGLISH    DWIGHT     GRAHAM     TANNER     ALINE     
PHOEBE     : KATHLEEN   HUBBARD    ALBERT    
FOX        : HUNTER     FOSTER     DANIEL     OBRIEN     ALFONSO    WEBB      
ROBERTA    : POOLE     
BENJAMIN   : BEACH      MELBA      PEREZ      SETH       HEWITT    
LEONOR     : MICAH      AYERS      ARMSTRONG  LINDA      HELENA    
TILLMAN    : ANDERSON   CECELIA    BUDDY      ANA        JUANITA   
AVIS       : FREDDIE    HULL       FOSTER     ELVA       BERNARDO  
ANDERSON   : TILLMAN    SANTIAGO  
JENNINGS   : BASIL      HARRIET    MACIAS    
LATONYA    : CRISTINA   GRIMES     LANGLEY    LEONEL     ALFRED     NANCY     
ODESSA     : DELMAR     PAYNE      TORRES     TRACY     
LILIANA    : MEREDITH   ISABELLE   SHANNON    SHARRON    PALMER    
LITTLE     : NICOLAS    CARMELO    MCCARTY    LEMUEL     ALI       
MADELINE   : ALVIN      REYNA      BILLIE     STEPHENSON
PERCY      : CHRISTA    TAMERA     BERGER     CARLO      POPE       EVANGELINE
WARD       : ROBIN      JAMAR      KELLER     WINFRED   
KNOX       : MARISOL    MEREDITH   BLEVINS    TASHA      DARCY      DUNCAN    
FIELDS     : ETTA       MARIE      LULU       HAROLD     OBRIEN    
AMIE       : HOLMAN     MAURICE    MCMAHON   
WITT       : ERIKA      ALISSA    
CANDICE    : ANDREA     MCINTYRE   HOWELL    
MONTGOMERY : POTTS      GONZALO    LELIA     
JANELLE    : FLOYD      RODRIQUEZ  NATASHA   
HOLDEN     : MILAGROS   WARREN     STEFANIE   VASQUEZ    RONNY     
DERICK     : ELLIS      WHITLEY    OTIS       DELMAR    
MEREDITH   : LILIANA    KNOX       CATHRYN    VAN        CARDENAS  
WALTERS    : ANDY       NOLAN      TAMERA     TERENCE    MCMAHON   
ABE        : JOY        BOWEN     
JACKIE     : NANETTE    ISABELLA   MADDEN     BARBRA    
COPELAND   : CRYSTAL    TABATHA    GRACE     
ESTES      : ROSETTA    GIOVANNI   KOCH      
HERRERA    : MONTY      JEFFERSON  DEENA      CAMACHO    ROBT      
THELMA     : COLON      SEBASTIAN  RODRIQUEZ  JACOB      HARMON    
MILAGROS   : HOLDEN     MARCUS    
ARIEL      : JACKSON   
MERCADO    : VALERIE    LAWSON     STEPHENSON PETERSEN  
MCNEIL     : MONTY      BRIAN      LORIE      RICHMOND   WATTS      KENTON     OLSON     
SIMON      : DANIELS    DUKE       ANDREW    
TODD       : ABRAHAM    WYATT      HANSON     MAE        MURIEL     GENARO    
MARCELINO  : HOOPER     JACLYN     SAUNDERS  
WILCOX     : NORTON     EDGARDO    KELLEY     JESSE      PATSY      CROSBY    
LEACH      : SPENCE     SIMONE     MAYER     
IRIS       : PATE       NUNEZ      MILLIE     VALENTINE  DALTON    
INES       : FREDERIC   MICAH      BRIANA     ESTEBAN    GENARO    
WEBSTER    : SOLIS      CURTIS    
RAMOS      : MCMILLAN   MUELLER   
BLACKWELL  : SAVANNAH  
ANIBAL     : BURTON     ADKINS    
DONOVAN    : BRENDAN    KRISTEN    HERRING   
LILA       : BUCK       VICKY      JOSEPH     ELVIRA     MORROW    
HOBBS      : HOLT       CANTU      DORA       CORNELIUS  CLAUDIA   
STACIE     : KAUFMAN    WATERS     WATTS      KRAMER    
CHRISTI    : BRIGITTE   FRANCIS    IAN        KNIGHT    
LOIS       : LEE        LAUREN     TYREE      FOREMAN   
JAMAAL     : MARK       ALLISON    BOWERS     BILLIE    
BALDWIN    : ROSETTA    GARNER     KERR      
MONTY      : HERRERA    MCNEIL     MARIBEL    EDITH      HORN       ERICKSON   LORNA     
HARRINGTON : HOLCOMB    ESTEBAN    ALEXANDRA 
PICKETT    : LUCILLE    BORIS      DALE       TIMMY      RAY       
EUGENIA    : EDITH      CURRY      HOLLAND   
SAM        : VICKY      EMILE     
OCTAVIO    : OLIVER     DIONNE     SCHWARTZ  
HAMILTON   : HUBER      MILLS      CARDENAS   JOHNSON   
CRISTINA   : KATY       LATONYA    HUBER      CRANE      ADDIE     
BRENDAN    : DONOVAN    ALVIN      GONZALEZ   HARMON    
BARRY      : MCCRAY     YVETTE    
WARREN     : HOLDEN     LACY       ODONNELL  
HANNAH     : RAMSEY     ERICK      ZAMORA    
ERIN       : ELMA       LUNA       FRANKS     AMANDA     ASHLEE     MACDONALD 
HOUSTON    : RODNEY     CHARLIE    MARKS      JOAN      
BELL       : DAVIS      WALL       CHRISTINE  REINALDO   WONG      
SWEET      : ELLIS      NOE        MERLIN     TOWNSEND   HELENA     COLLINS   
BARLOW     : DANA      
DUNN       : FRIEDA     CATHERINE  LESSIE    
LANA       : GARTH      ERICK      SIDNEY     EMILE      AYALA     
YANG       : LEVI       FRIEDA     DEANA      REYNA      MUELLER   
ANDY       : WALTERS    SYDNEY    
HIRAM      : MARK       BURT       DONNY      ALEXANDRA  MARISSA   
CONNIE     : STEWART    SHEPHERD   CONSUELO  
BARNES     : BURGESS   
JEFFERSON  : HERRERA    SERGIO     BOB        MALLORY    RAY        FULLER    
PAMELA     : IRWIN      GONZALO    LORIE      ANTONIA    NOEMI      ROBERT    
MERCEDES   : MAVIS      DODSON     ROBLES     JARROD     BILLIE     HUDSON    
HORTON     : WILFORD    TRAN       ADAMS      ROBERT    
HERBERT    : HENDERSON  HICKS      ANTONIO   
BARRERA    : EDITH      POTTS      WILLIAMS  
MCCONNELL  : GRIMES     ANDREW     CHARLES   
ROSALIE    : OLIVER     LORRAINE   SHIRLEY   
CHARLOTTE  : SHAWN      NEIL       SIMONE     ELBERT     JULIAN    
JILL       : LANDON     TOM        FOWLER     MARKS     
MAC        : DENIS      MICHEAL    KELLY     
WALDO      : CROSS      BENITO     LENORA    
LEVI       : YANG       MOLLIE     WILEY      WILKINSON  TANIA     
WARNER     : TAMMI      MORROW     HUFFMAN    FUENTES    CASEY     
HARRELL    : LEE        TINA      
GOMEZ      : VICKY      TREVINO    CANDY     
SOTO       : CORRINE    QUINTON   
ABRAHAM    : TODD       MCKEE      WILLIS     ADELINE    JOHNSON    PETERSEN  
JIMENEZ    : HENSON     BEACH      HENDERSON  AUBREY    
ALLISON    : JAMAAL     BYRD       ROBINSON   CECIL      FRANCESCA  JULIE     
BUCKNER    : GILMORE    KATHY      LAMBERT   
FREDERIC   : INES       FERNANDEZ  PACHECO    HERMAN     JILLIAN    CHARMAINE  RICHARDSON
COMBS      : PERRY      MCFADDEN   PACHECO    HUFFMAN    GREENE    
DODSON     : MERCEDES   MURIEL    
REBEKAH    : MONICA     GENARO    
ROSETTA    : ESTES      BALDWIN    GILL       WILL       MCCALL     SANDOVAL   FREDRIC    COLLEEN   
HARDY      : BAIRD      CROSS      CONNER     INA        NICHOLSON 
VELASQUEZ  : HERRING    HAWKINS   
WEBER      : DEWAYNE    HENSON     MCMAHON   
BAIRD      : HARDY      TREY       MAXINE    
ALEXANDER  : BALLARD    MICHEAL    MAXINE    
BRYON      : WIGGINS    JULIE      BARTON    
MARGARITA  : HENSLEY    CAMACHO   
OCONNOR    : OSCAR      COOK       JARROD     TEDDY      SALVATORE  BAUER     
ALVIN      : MADELINE   BRENDAN    MARGERY    PUCKETT    RACHAEL   
FOREST     : CLARK      AHMED      IAN        CALVIN     LORAINE   
CHARITY    : BILLIE     KRISTINE   REILLY     DEAN      
COOKE      : RITA       GIBBS      STANLEY    CAROLE     RACHAEL   
DIONNE     : OCTAVIO    WENDI      LACEY      DAMON      SHELLEY   
TRICIA     : NEAL       SERRANO    WELLS      GEORGIA    KASEY     
VERA       : RIOS       ROBT       MYERS     
NUNEZ      : LUCIEN     IRIS       SYDNEY     RITA       WILEY      COX       
ALBA       : KNOWLES    NITA       EARL       SUSIE     
ISSAC      : CORY       GLADYS     ERIK      
FLOSSIE    : MARION     NICOLE     MCFADDEN   HOWELL     KANE      
ELMA       : ERIN       DONNA      THURMAN    LACEY     
BLEVINS    : GLENN      KNOX       KURT       MARGARITO  CAMERON    HOWARD     MCGOWAN   
BUCK       : LILA       INGRID    
NICOLE     : PAGE       FLOSSIE    THURMAN    ORR        NORMA      MAYER      CAROL     
MCMILLAN   : RAMOS      PRUITT     JILLIAN   
REEVES     : FULTON     HICKS      NADINE     MARCEL    
BYRD       : ALLISON    TYREE      ANNETTE    KRISTEN    MOISES     STEPHENSON
MOSES      : NOE        KATHLEEN   HERIBERTO  MORROW     HARRIS     BEASLEY   
IRWIN      : RAMSEY     PAMELA     FLETCHER   MALDONADO 
CAITLIN    : VONDA      MEDINA     REUBEN     MYRA       MCCLURE   
STEPHENS   : QUINCY     WHITNEY   
SYDNEY     : ANDY       NUNEZ      DOMINGO    MABEL      GENEVA    
DINO       : PITTS      MILLER     ABEL       MERLIN     EARLE      ROSALINDA 
CLEMENTS   : RICHARD    REUBEN     SHARON     MILLS     
MCCARTHY   : SEARS      CARLO     
OSCAR      : OCONNOR    ROMERO     VEGA       GRACIELA   OBRIEN    
GRIFFIN    : SCHULTZ    MARCEL    
LUNA       : ERIN       HINES      CHELSEA    LUPE       TATE       DECKER     GATES      FRANKLIN  
MCKEE      : ABRAHAM    ROMERO     MARIE      ROSA       DELORIS    GARNER    
IVANA      : CUNNINGHAM CARISSA    CHANCE     KRYSTAL   
BAKER      : BRANDY     SYBIL      HERSCHEL   FINLEY     ANNABELLE 
DEENA      : HERRERA    WELCH      KENNEDY    LUPE       CARROLL    SHANNON    FRANKIE    SAVAGE    
WINTERS    : LACEY      DANA      
EMORY      : MONTOYA    FULLER     FAITH     
ROBBIE     : LUPE       JESSE      ASHLEY    
WEISS      : LUCIEN     JUSTINE   
LAUREN     : LOIS       DON        MCCLURE   
ODELL      : WALTON     JOANNA     MCFADDEN   ERNESTINE  LINDSAY   
KNOWLES    : ALBA       GALEN      FRANCIS    GOOD      
ROBBY      : TASHA      OMAR       BRADSHAW   DON       
STUART     : OLGA       JOHNSON   
OLA        : HART       HORN       POPE       SHEPHERD   DAVID      VERNON     ERIK       WEBB      
GARTH      : LANA       JOHNATHAN  DAPHNE     EFREN      HELENA    
BEAN       : RIVERA     NETTIE     ZAMORA     OTTO      
ANITA      : TASHA      KATHY      BURTON     GALEN      GLORIA     JAYNE      HOUSE     
VELMA      : JOHN       LIZZIE     MARIANO    WINFRED   
KRISTIE    : CHAVEZ     HENDERSON  TERRY      ARNULFO    CHRISTINE 
ARRON      : MILLER     DONA       AMADO     
JOHANNA    : HEATH      DUSTY      EVANGELINA RICHMOND   DIXON      SHELLEY    BETH      
BETTE      : BERNADETTE CAROLINE   MCCRAY     ALISSA    
ROBINSON   : ALLISON    JOYCE      NETTIE     SERRANO    FINLEY    
TABATHA    : COPELAND   BEST       DIANE      MCCORMICK  GENEVA    
GRIMES     : LATONYA    MCCONNELL  MCKENZIE  
DARNELL    : DIANE      ADAMS     
GILBERT    : FORBES     LULU       JOSUE      OLSEN      SELLERS   
PITTS      : DINO       KENDALL    HOLT       DELBERT   
SANTIAGO   : ANDERSON   WILL       WATTS     
CLAYTON    : KLINE      KRISTOPHER MASSEY     LACY       ERNA      
GARRETT    : BEST       BOBBI      KRISTINE  
MARIA      : KOCH      
FISCHER    : THURMAN   
CARNEY     : WILLIAMS   CUMMINGS   ENID       KANE      
DILLON     : JULIO      SANFORD    ELBERT     CALVIN    
CASE       : STEELE     BERTIE     FREDDIE    ALFREDA    HECTOR    
PITTMAN    : URSULA     HILARIO    LUPE       LAUREL     LINDA      DAREN      VAUGHN    
SCHNEIDER  : MUELLER    PATSY      GONZALES  
WYATT      : TODD       MARGUERITE EVANGELINA TOMMY     
MCLEOD     : FARLEY    
MCLAUGHLIN : ROSS       STEVENSON  CAROLE    
WELCH      : DEENA      KATHARINE  CATHERINE  SHARON     DECKER     WINFRED   
MCKENZIE   : GRIMES     CRAFT      MEDINA     BOWMAN     MARTIN    
HART       : OLA        HENDRIX    ROCKY      SELLERS   
SPENCE     : LEACH      PENNINGTON STEELE     LANCASTER  SHARON     DEVON      OWEN       CASSIE    
PENNINGTON : SPENCE     GEORGE     MARVIN    
JOHNS      : BENNIE     LORENZO    AHMED      ERMA       BERNARDO  
HANSON     : TODD       SYKES      HURST      KELLY     
NOLAN      : WALTERS    STEFANIE   MILLIE     SHERRI    
DEJESUS    : WILL       BARKER     BUCKLEY    BURKS      MITCHELL  
BURT       : HIRAM      GENEVA    
HUNTER     : FOX        THURMAN    BOLTON     KYLE       AMADO      GALLOWAY   KEVIN     
MICAH      : LEONOR     INES       SILVA      PAM        TRUDY     
FANNIE     : LARSON     DECKER     CUMMINGS  
CORY       : ISSAC      ELDON      ELLIOTT    SUSIE      DELBERT    WONG      
REYES      : CARSON     TUCKER     VAUGHN    
URSULA     : PITTMAN    ROSE       DURAN     
JARVIS     : SILAS      BOLTON     PAT        JOSH       MONA      
JUSTINE    : LENARD     WEISS     
MARIBEL    : MONTY      BURGESS    RICKY     
RODNEY     : HOUSTON    LUCIANO    DARCY      ROMAN      LACEY     
HEBERT     : SONYA      REINALDO  
SILVA      : MANN       MICAH      TUCKER     GRACE     
JACLYN     : MARCELINO  SHARON     SETH      
PHILLIPS   : MILES      SHERYL     JONI       ARTHUR     JOYNER    
TOBY       : LAMBERT    ROD       
GONZALEZ   : BRENDAN    PACHECO    LINDSAY    VALENZUELA HARPER    
ELLIS      : DERICK     SWEET      CHAVEZ    
CHARLIE    : HOUSTON    BERT       LES        CHANCE    
HOLMAN     : KATY       AMIE       JODIE      FEDERICO   SOFIA     
EDMUND     : RICHARD    NANETTE    LORIE      CARROLL    DON        PETERSEN  
FRY        : HARMON     COLLIN     NOEMI      ALBERT    
CARSON     : REYES      BRIAN      TAMMI      MAYS       ANTONIA    COX        AYALA      JOAN      
HUGHES     : ISRAEL     RICHARDS   QUINN     
BURGESS    : BARNES     MARIBEL    SAMUEL     WENDY     
AUSTIN     : STRICKLAND EVANGELINA CARLA     
PIERCE     : CUNNINGHAM PACHECO    RONNY      ROBERTSON 
DENIS      : MAC        SIMPSON    PARSONS   
CHANG      : TRACEY     RUTLEDGE   DOYLE      HOPKINS    EARL      
HINES      : LUNA       SANFORD    NANCY      ESTELLA    CHARLENE  
TRACEY     : CHANG      RICARDO    LOWE       GRACIELA   BRAY       SELLERS    LYNN       HILL      
DARYL      : PAGE       PAM        MENDOZA   
DIAZ       : BRADLY     BRAY      
CECELIA    : TILLMAN    RUSSELL    SAMPSON    MATHIS     SHERMAN   
LARSEN     : STEELE     BALLARD    BRANDY     MARKS      QUINN     
RICE       : TREY       ANNETTE    HERSCHEL   MANNING   
BRIAN      : CRYSTAL    MCNEIL     CARSON     ADAM       AUBREY    
JOHNATHAN  : GARTH      EDITH      HERMINIA   HOLDER     FRANCIS   
BENNIE     : JOHNS      HOUSE      ROSALINDA 
ERICK      : HANNAH     LANA       VONDA      STOUT      WOODWARD   RONALD     KERR      
LEANNE     : DYER       JARED      ANTONIO    PARKS     
KENT       : HARVEY     JAY       
COOLEY     : DEWAYNE    SERRANO    SANCHEZ   
TASHA      : GLENN      KNOX       ROBBY      ANITA      HEATH      ROBLES     ERNA      
BERT       : CHARLIE    CHERI      AVERY      JACOBS     SWANSON    ESTEBAN    BIRD      
GUY        : CARISSA    FERNANDEZ  FORREST   
CLARK      : FOREST     KATHARINE  TEDDY     
TUCKER     : COLON      REYES      SILVA      HAWKINS   
VONDA      : CAITLIN    ERICK      LEWIS      VANCE     
FROST      : JAYNE      DAREN     
NORTON     : WILCOX     SAVANNAH  
CRAFT      : MCKENZIE   KATHY      FLORES     FOWLER     PATRICK   
LYDIA      : BOYER      MONTOYA    HOLLOWAY  
FRYE       : JEREMY     DUNCAN     LOGAN     
SELENA     : NANETTE    ARTHUR     MOSLEY     PALMER    
BRIDGETTE  : NEIL       MORENO     OBRIEN     WELDON    
WOLF       : EVERETT   
THOMAS     : HARVEY     WALTER     SCHROEDER 
YOUNG      : FARLEY     DOROTHEA  
DEANDRE    : ANDREA     REUBEN     RONALD     RORY      
KIM        : KIDD       WHITNEY    HUDSON     CUMMINGS   MARVIN    
ENGLAND    : KATY       KIDD       OTTO      
CHELSEA    : LUNA       GRETA      AVERY      GILES     
AGNES      : CASTILLO   MIKE       ELIZA      ASHLEY    
SILAS      : MCKAY      JARVIS     HOLT       MASSEY     LEONARD    VARGAS    
MAGGIE     : MCINTYRE   ARNULFO    CLINT      ELINOR    
HIGGINS    : KRISTOPHER ONEIL      GREENE    
TYREE      : LOIS       BYRD       BARTLETT   JULIA      REUBEN     SIMONE    
ELOISE     : CASTRO     TRAVIS    
TOM        : VILMA      JILL       BREWER     HOWARD    
MARGUERITE : WYATT      MARKS     
DEWAYNE    : WEBER      COOLEY     MILLICENT  BURTON     MALDONADO  MAYS       NORA       CRAIG     
FLOYD      : JANELLE    SAMUEL     TREVINO   
RICHARD    : CLEMENTS   EDMUND     WHITAKER   COLLEEN   
EDITH      : MONTY      EUGENIA    BARRERA    JOHNATHAN  CHANDLER   HENDRIX    JAMEL     
WHITAKER   : RICHARD    KATHY     
ANNIE      : LANE       WILEY      INGRAM    
FLETCHER   : IRWIN      CONLEY     AUTUMN    
CHRISTA    : PERCY      CHAN      
LEONARDO   : CALLAHAN   JUANITA    HERSCHEL   HARRISON   TANYA     
LANGLEY    : LATONYA    RIOS       RICHARDS  
STEFANIE   : HOLDEN     NOLAN      QUINCY     ERICKSON   THADDEUS  
STEELE     : CASE       SPENCE     LARSEN     HORN       CHAVEZ     EARLE     
BARTLETT   : TYREE      JOYCE      SETH       TERRENCE  
KLINE      : CLAYTON    SHARON    
KRISTOPHER : CLAYTON    HIGGINS    ROBIN      ERMA       NAVARRO    ANASTASIA 
ETTA       : FIELDS     MARKS      DEWITT    
ISABELLE   : LILIANA    LARSON     REGGIE     EVE        TRACY     
AMELIA     : IGNACIO    BARKER     BILLIE     ARTHUR     RENA      
TARA       : ANDREA     NEAL       JOHNNIE   
ALTON      : BORIS      CHERI      CONRAD     DUSTY      OTTO       NELDA      ROTH      
BALLARD    : ALEXANDER  LARSEN     GIOVANNI   SERGIO     VICTORIA   CANDY      GLOVER    
ROMERO     : OSCAR      MCKEE      COLLIER    DELANEY   
RIVERA     : BEAN       JOYCE      HERIBERTO  NANCY      CHARLENE   TYLER     
JOY        : ABE        MARY       LOURDES   
ALTA       : GLADYS     AUTUMN     JOHNSTON  
MARIE      : FIELDS     MCKEE      MARYELLEN  CLEMONS    GREENE    
MCCULLOUGH : EMILY      MAYNARD   
SEARS      : MCCARTHY   CLYDE      MCCRAY     COTTON     FLYNN      GIBBS      JOHNSTON  
NEWMAN     : WIGGINS    PATEL      DANIELS    LINDSEY   
JODIE      : HOLMAN     DAWN       CAROL      KASEY     
JAIME      : MARK       LUCILLE    GRACIELA  
BROCK      : STRICKLAND AYERS      CHAVEZ     NORRIS     PARSONS   
SLOAN      : MICHEAL    SAUNDERS   ESTELLA   
NICOLAS    : LITTLE     HANEY      DONALD     IRVIN      GENARO    
HENSON     : JIMENEZ    WEBER      NEWTON    
CLAUDETTE  : JOSEPHINE  RUSSEL    
MILLICENT  : DEWAYNE    ERNESTINE  SAUNDERS   JOHNNIE   
RIOS       : KATHERINE  TRENTON    ANTONE     VERA       LANGLEY    SHERYL     PATEL     
XAVIER     : MALDONADO  HENDRICKS 
CONLEY     : FLETCHER   WATERS     DAVENPORT 
ROSE       : URSULA     GARZA     
MARYANNE   : PATE       BUDDY      SANDOVAL   MYRA       MEADOWS   
DAVIS      : BELL       KATHARINE  GLOVER    
POTTS      : MONTGOMERY BARRERA    ELISEO     REINALDO  
MEDINA     : CAITLIN    MCKENZIE   KIDD       CHERRY     BARR       MCLEAN     PARKS     
WIGGINS    : BRYON      NEWMAN     LORRAINE   DENNIS     VALENTINE  MAXINE     CORNELIUS  BARTON    
BRANDY     : BAKER      LARSEN     MIKE      
BERTIE     : CASE       RITA       BERNADETTE FRANKLIN  
BRIGHT     : CROSS      TREY       COLEMAN    RICK      
FRANKS     : ERIN       FRIEDA     WILLIS     SHEPARD    KARLA      CASTRO     RAUL      
FORBES     : GILBERT    MERCER     JOHNNIE   
MARY       : JOY        WILFORD    KELLY     
CARLENE    : AYERS      WENDY      WATTS     
HARVEY     : KENT       THOMAS     HOGAN     
MILLER     : DINO       ARRON      RUSSO     
DARRELL    : PRISCILLA 
FEDERICO   : HOLMAN     RICHARDS   ONEIL     
LEWIS      : VONDA      JASPER     ROSEMARY  
CECIL      : ALLISON    BULLOCK   
RICO       : DELACRUZ   BARBER     KIDD       SUSANNA   
LUCIANO    : RODNEY     GIOVANNI   BUDDY      SCOTTIE    BENTON     BOBBI      CHARMAINE  ETHEL     
FRIEDA     : DUNN       YANG       FRANKS     CLARENCE   JULIAN    
PETTY      : WOLFE      ERNIE      NOEL      
TAYLOR     : PRESTON   
ERIKA      : WITT       NICHOLS    GENARO     DEWITT     WEBB      
WILFREDO   : MUNOZ      ANASTASIA 
STRICKLAND : AUSTIN     BROCK      MAYS       SHAWN      SONNY      KENTON     CURRY     
CASANDRA   : ANNMARIE   JOHNSON   
FREDDIE    : AVIS       CASE       POOLE      CURTIS     PARSONS   
ISRAEL     : HUGHES     CAIN       WINFRED   
AMANDA     : ERIN       EARL       LUISA     
MOLLIE     : LEVI       CLARENCE  
GILL       : ROSETTA    DANIAL    
BONITA     : MAYS       BOB        WELLS      DONALD     ROJAS      LEON      
GARRY      : RASMUSSEN  JIM        MAURICE   
JORDAN     : LETITIA    LOURDES    DYER       JANETTE    WALLS      KEITH      KANE      
KATHY      : BUCKNER    ANITA      CRAFT      WHITAKER   LUCY      
DAPHNE     : KATHERINE  GARTH      SUAREZ    
WALSH      : LOURDES    STEVENS    LANG      
ANDREA     : CANDICE    DEANDRE    TARA       NANNIE    
TAMERA     : PERCY      WALTERS    IGNACIO   
NOE        : SWEET      MOSES      JUAREZ     CHANCE    
GIOVANNI   : ESTES      BALLARD    LUCIANO    MICHEAL   
WILL       : ROSETTA    SANTIAGO   DEJESUS    OTIS       GEORGE     HARMON     CARLA     
JOYCE      : CARLSON    ROBINSON   BARTLETT   RIVERA     KARYN      CONRAD    
WHITLEY    : DERICK     ROSS      
WEEKS      : JANINE    
HILARIO    : PITTMAN    MANUEL     FARLEY    
CHAN       : CHRISTA    GLADYS     CARLO      HAYS       RUSSO     
BEST       : TABATHA    GARRETT    SALINAS    SANCHEZ   
FLORES     : CRAFT      MALLORY    VERNON     BLAKE     
JOANNA     : ODELL      DOMINGO    GENEVA     WATERS     KANE      
DONNY      : HIRAM      BENITO     MENDOZA   
BRADLY     : DIAZ       BRADFORD  
BUTLER     : BRIANA     SYBIL      HOWARD     GIBBS      COLLINS   
VASQUEZ    : HOLDEN     HUBER      SALINAS    DEWITT    
NICHOLS    : MAVIS      ERIKA      LIZZIE     MELBA      HERMAN    
KERRY      : ZAMORA     FRANKIE    LANG       JULIAN     BEASLEY    MCBRIDE   
BORIS      : PICKETT    ALTON      PATEL      NOEL      
VICKY      : LETITIA    LILA       SAM        GOMEZ      GEORGE     GALLAGHER  MARISSA   
COOK       : OCONNOR    EVERETT    HOLDER     GOLDIE     MILDRED    RICHARDSON
ROY        : ROJAS      OLSEN      JAMEL     
BOWERS     : JAMAAL     GRAHAM    
HEATH      : JOHANNA    TASHA     
STOUT      : ERICK      CARVER     RANDOLPH  
CLYDE      : SEARS      FIGUEROA   BURRIS     CALVIN    
DANIELLE   : CAMACHO    JILLIAN    MINNIE    
PHILIP     : FERNANDEZ  REFUGIO    BRIGGS    
HANEY      : NICOLAS    ADAMS      ARNULFO    ALYSON     MCLEAN     RUSSEL    
RUTLEDGE   : CHANG      BEACH      RICHARDS   FULTON     STANTON    DARRYL    
DONA       : VILMA      ARRON      CRANE      AMADO      HARRIET   
LOURDES    : JOY        JORDAN     WALSH      JOSEPHINE 
MCFADDEN   : LESLIE     COMBS      FLOSSIE    ODELL      SALAZAR    GLASS      MAYNARD   
TIMOTHY    : MAXWELL    SHIRLEY    ERMA       SANTANA    BRADFORD  
DIANE      : TABATHA    DARNELL    LEONEL     FREEMAN    DIXIE      RUSSEL    
NEAL       : TRICIA     TARA       COLLINS    MAURICE   
KATHARINE  : WELCH      CLARK      DAVIS      SHEPARD    MYERS      BUCKLEY    PAYNE      JOSEPHINE 
KRISTINA   : SERGIO     PRESTON    OTTO      
BOBBIE     : LIZZIE     SWANSON    DARIN      GIBBS     
MANUEL     : HILARIO    SHERYL     SHANA      PATSY     
ANNMARIE   : CASANDRA   LOTTIE    
SCOTT      : BRADFORD   ERNA       FERRELL   
PECK       : GLASS      RUSSEL    
CANTRELL   : GEORGE     NADINE     OBRIEN    
JULIO      : DILLON     ABEL       ANA       
ABEL       : DINO       JULIO      KANE       BOWEN     
ROCCO      : ANTONE     DENA       GERARDO    FULTON     DURAN     
FIGUEROA   : CLYDE      ISIAH     
JULIA      : TYREE      RASMUSSEN  HOLCOMB   
HENSLEY    : MARGARITA  YVETTE    
ROXANNE    : ANTONE     LORI       BARBER     BRADSHAW   HENDRICKS  DON        GRAHAM    
BURTON     : LENARD     ANIBAL     ANITA      DEWAYNE    KAUFMAN    LENORA     TONIA     
GLADYS     : ISSAC      ALTA       CHAN       CALLAHAN  
SIDNEY     : LANA       COLLIER    HEIDI      FAITH      SANTANA   
WOODWARD   : MAVIS      ERICK      NANETTE    BRUCE      KIDD       PAT        FUENTES   
LAMBERT    : BUCKNER    TOBY       TAMMI      ADKINS     HALL      
DEANA      : YANG       BOYLE      MATTHEWS   FERRELL   
CAROLYN    : TAMMI      MARYELLEN  FLORINE    MASSEY     JEWELL     BIRD       CALVIN     ARTHUR    
CAROLYN    : JULIAN    
CUNNINGHAM : IVANA      PIERCE     TREY       MYRA      
SARA       : WISE       COTTON     NADINE     DANA      
KERI       : VALENTINE  CHARLENE   CARLA     
GONZALO    : MONTGOMERY PAMELA     MARTINEZ   RITA       MACK      
DOYLE      : CHANG      PAULETTE   DAMON      FINLEY    
ADAM       : BRIAN      KARYN      JAY       
IGNACIO    : MARISOL    AMELIA     TAMERA     WILBUR     DELGADO    SYKES     
GREGORY    : VILMA      SHEPARD    DONALD    
WOLFE      : PETTY      SOLIS      AURELIA    STACI      MUELLER    VALENCIA   POOLE      BARNETT   
MILES      : PHILLIPS   TOMMY      GILLESPIE  GENARO     WINFRED    WELDON     REGINA    
HORN       : MONTY      OLA        STEELE     SYBIL     
MORRIS     : CROSS      MACDONALD 
STARK      : VIRGIE     RAPHAEL    COFFEY     JOHNSON    SALVATORE  RUSSO     
LORENZO    : JOHNS      SNOW       CONCEPCION TY        
KENNEDY    : DEENA      KASEY     
ROBLES     : PERRY      MERCEDES   TASHA     
LEBLANC    : MARCI      MOHAMED    HUMBERTO  
REUBEN     : CAITLIN    CLEMENTS   DEANDRE    TYREE      ELVA       TANNER     BEASLEY   
LYMAN      : CHANDLER   CLARA      IAN       
DALE       : PICKETT    MURIEL     VAN        DALTON     CASEY      GILBERTO  
DARCY      : KNOX       RODNEY     CORINNE    CAIN       BEASLEY   
SERGIO     : JEFFERSON  BALLARD    KRISTINA   MARA       FOWLER    
DONNA      : ELMA       HOLT       COTE       RUSSO     
ENRIQUE    : BERNADINE 
SHERYL     : PHILLIPS   RIOS       MANUEL     NOELLE    
MARTINEZ   : GONZALO    FARLEY     PETER      BILLIE     COFFEY     PARSONS   
ART        : PORTER     DANIELS    NAPOLEON   ADDIE      GALLOWAY   HILL      
LOTTIE     : ANNMARIE   JANICE     EMILY      SCHWARTZ   HELGA     
CHERI      : MONICA     BERT       ALTON      JONI       ERMA       GRAY      
COLLIER    : ROMERO     SIDNEY     TAMMY      AVA        WASHINGTON KRYSTAL   
HINTON     : SHIRLEY    AUGUSTINE 
HUBER      : HAMILTON   CRISTINA   VASQUEZ    SUSAN      MARIANA   
MIKE       : MCKAY      PRINCE     AGNES      BRANDY     HECTOR     MICHAEL   
RONALD     : ERICK      DEANDRE    RICHARDS   CARLO     
MCCALL     : ROSETTA    TAMMIE    
ALFREDA    : CASE      
KARYN      : RAMIRO     JOYCE      ADAM       BERNARDO  
THOMPSON   : REGGIE     MONROE     EVANGELINE
HURLEY     : CLAY       GUTHRIE    VICKI     
HULL       : AVIS       CASTRO     MONROE    
MARCI      : LEBLANC    JUANITA    GONZALES   HOWARD    
TAMMI      : WARNER     CARSON     LAMBERT    CAROLYN    MARYELLEN  WALLER     HOGAN     
ELISEO     : POTTS      NETTIE    
CAMACHO    : HERRERA    MARGARITA  DANIELLE   ROSS       CARROLL   
LENORE     : JOYNER     TY        
BOYD       : BRIANA     OMAR      
HEIDI      : SIDNEY     PAULETTE   AHMED      DANIEL    
CARISSA    : IVANA      GUY        BOYER      HICKS      BREWER    
MALDONADO  : OLGA       IRWIN      DEWAYNE    XAVIER     VALENZUELA DALTON    
CARMINE    : FREDRIC    TY        
PAULETTE   : DOYLE      HEIDI     
HOPKINS    : CHANG      JANINE     ALEXANDRA  CORRINE   
MARYELLEN  : MARIE      CAROLYN    TAMMI      CALDWELL   LAURI     
MOSS       : QUINCY     KENTON    
CHANDLER   : EDITH      LYMAN      GOLDIE     GATES      RENA      
GRETA      : CHELSEA    JACOBS     TEDDY     
LORRAINE   : ROSALIE    WIGGINS    LEONEL    
RASMUSSEN  : GARRY      JULIA      DIXON      MOODY      JULIET     CHERRY     TONI      
CROSS      : WALDO      HARDY      BRIGHT     MORRIS    
AYERS      : LEONOR     BROCK      CARLENE    MADDEN    
BEACH      : BENJAMIN   JIMENEZ    RUTLEDGE   VALENCIA   MARSH     
ODOM       : CAIN      
KENDALL    : PITTS      ERNESTINE  HERMAN     SOSA       LANG      
PAM        : MICAH      DARYL      JOSEPHINE 
VICTORIA   : BALLARD    TERRELL    STEPHENSON
DENA       : MARISOL    ROCCO      EARLE      LOGAN     
LANE       : ANNIE      TAMMIE     MARSH     
SUAREZ     : DAPHNE     BOB        LON        SCHROEDER  TRACY     
MARA       : SERGIO     GARZA      ELBERT     QUINTON   
CLAY       : HURLEY     DUKE       MARCY      SUSANNA   
HOLLIE     : COTE      
CHAVEZ     : KRISTIE    ELLIS      STEELE     BROCK      RORY      
LES        : CHARLIE    CASSIE    
THURMAN    : ELMA       NICOLE     FISCHER    HUNTER     JOSUE      DEVON     
HUGH       : FOREMAN    MEADOWS   
SCHULTZ    : GRIFFIN    FOSTER    
SAMUEL     : BURGESS    FLOYD      AURORA     PRESTON   
FRANCESCA  : ALLISON    CONRAD     KATHLEEN   FREEMAN    HENDRICKS 
HOLCOMB    : HARRINGTON JULIA      AIDA      
SHANA      : MANUEL     BOWMAN     BATTLE     HOFFMAN   
BUDDY      : KATHERINE  MANN       TILLMAN    MARYANNE   LUCIANO   
NIGEL      : FRANCIS    HECTOR    
MILLIE     : IRIS       NOLAN      DELANEY   
RICHARDS   : HUGHES     LANGLEY    FEDERICO   RUTLEDGE   RONALD     QUINCY     FERN      
BERGER     : PERCY      RITA       FERRELL   
BURCH      : JERALD     PRISCILLA  QUINN     
SOLIS      : WEBSTER    WOLFE      HENDRICKS 
FARLEY     : ROB        MCLEOD     YOUNG      HILARIO    MARTINEZ   LANCASTER 
DOMINGO    : SYDNEY     JOANNA     EVERETT    FOWLER     ERMA       ADKINS    
DOROTHEA   : YOUNG      KATHLEEN   JAMEL     
ELIZA      : AGNES     
RODRIGUEZ  : GUTHRIE    GRAHAM    
JOSEPH     : LILA       TANYA      CONSTANCE 
GALEN      : KNOWLES    ANITA      NIEVES     LORNA      OWEN      
MOLINA     : DUSTY      ROD        GALLAGHER  MINNIE    
RICARDO    : KATY       TRACEY     GARZA      MOODY      JAMAR     
CARMELO    : LITTLE     BOBBI      HOFFMAN   
RODGERS    : WALTON     ERNESTINE  BIRD       MINNIE     TRACY     
ORR        : CRYSTAL    NICOLE     JOSH       BAUER     
DAWN       : KATY       JODIE      LON        DUNLAP    
PETER      : VILMA      MARTINEZ   HERSCHEL   WILLIE     LUCY      
LULU       : FIELDS     GILBERT    DUFFY      GILBERTO  
TREY       : BAIRD      RICE       BRIGHT     CUNNINGHAM NORRIS     TAMMIE     STEPHENSON
HENDRIX    : HART       EDITH      RUSSELL    WISE       GLORIA    
SUSAN      : HUBER      HAYS       JEWELL    
LUPE       : LUNA       DEENA      ROBBIE     PITTMAN    JANICE     DON       
JONI       : PHILLIPS   CHERI     
HERMINIA   : JOHNATHAN 
EVERETT    : WOLF       COOK       DOMINGO    KIP        HERMAN     SIMPSON    REYNOLDS  
WEAVER     : KATY       GRACE      ELINOR     LESSIE    
NETTIE     : BEAN       ROBINSON   ELISEO     BETHANY    FRANKIE    RACHAEL   
WILLIS     : ABRAHAM    FRANKS     BROWN     
VERN       : LAURI      WHITNEY    CHARMAINE 
RITA       : COOKE      NUNEZ      BERTIE     GONZALO    BERGER     NICHOLSON 
EMILE      : SAM        LANA       AL         MENDOZA    ISABELLA   BETH      
FERNANDEZ  : FREDERIC   GUY        PHILIP     CLEMONS   
ALVAREZ    : FLORENCE   ROWE       LYNN      
ED         : HATFIELD   MARGARITO  VARGAS     MCCLURE   
BOYER      : LYDIA      CARISSA    TERRI      JULIE      CHANCE     ALINE     
FLORINE    : CAROLYN    KELLER    
FOWLER     : JILL       CRAFT      SERGIO     DOMINGO    LELIA     
LATISHA    : MATHIS     REINALDO  
LETICIA    : RAMSEY     VICKI      HARRISON   LORNA     
CARLO      : PERCY      MCCARTHY   CHAN       RONALD     FRANCIS   
CONRAD     : ALTON      JOYCE      FRANCESCA  JESSIE     ESMERALDA 
ELVIRA     : LILA       LACY       RUSS      
MERLIN     : HOOPER     SWEET      DINO       DUFFY     
KOCH       : ESTES      MARIA      JESSIE     REFUGIO   
PARK       : ALFONSO   
KEVEN      : ROSEANN    GILLESPIE 
ARMSTRONG  : LEONOR     PATRICK   
KURT       : BLEVINS    WALLS      ALICIA     TANYA      CORRINE   
ZAMORA     : HANNAH     BEAN       KERRY      TRACY     
SEBASTIAN  : THELMA     WILBUR     BOLTON     SANFORD   
AL         : EMILE      BRUCE      SUSIE      ALYSON    
MARCUS     : MILAGROS   HOLDER     CEDRIC     HOWARD    
MICHEAL    : MAC        ALEXANDER  SLOAN      GIOVANNI   NANCY      RODERICK   CROSBY    
BLANCHARD  : JOHN       MARCELO    ROWE      
TREVINO    : GOMEZ      FLOYD      DUKE      
DUSTY      : JOHANNA    ALTON      MOLINA     MCCARTY    HILL      
BRIGITTE   : CHRISTI    ESMERALDA  KRISTINE  
ROSS       : MCLAUGHLIN WHITLEY    CAMACHO    FERN      
SONYA      : HEBERT     WILEY      CLEVELAND  SUSIE     
LELIA      : MONTGOMERY FOWLER     VEGA       CASTRO     STANLEY    HARPER    
ROSEANN    : KEVEN      DORA       BERNARDO   RANDOLPH  
OTIS       : DERICK     WILL      
NORRIS     : WALTON     BROCK      TREY       LORI      
SALAZAR    : MCFADDEN   RUSSO      PARKS     
MAE        : TODD       ALINE     
WILEY      : LEVI       NUNEZ      ANNIE      SONYA      WILFORD   
LEVINE     : VERNON     BOBBI      GLOVER     MCCLURE   
NITA       : ALBA       VEGA       LARSON     JEAN      
CATHERINE  : DUNN       WELCH      QUINN      LYNN       ETHEL     
BARKER     : DEJESUS    AMELIA     ROBT       CAIN       WILLIE    
JESSIE     : MARK       CONRAD     KOCH       BRIDGET   
PATEL      : NEWMAN     RIOS       BORIS      AURELIA   
LORI       : ROXANNE    NORRIS     BRUCE      NEIL      
TERRI      : BOYER      ELLIOTT    SCHWARTZ  
MAYS       : CARSON     DEWAYNE    STRICKLAND BONITA     MYRA      
FOREMAN    : LOIS       HUGH       WHITFIELD 
ROCKY      : HART       SCOTTIE    GOOD       COLLIN    
GERARDO    : ROCCO      BETHANY    TINA       COMPTON    MAYNARD   
FRANCES    : JANICE     JULIET    
EDGARDO    : WILCOX     TIMMY     
PORTER     : ART        NORMA      SOSA       CLEMONS   
NANETTE    : JACKIE     EDMUND     SELENA     WOODWARD   QUINTON   
PACHECO    : FREDERIC   COMBS      GONZALEZ   PIERCE    
KATHLEEN   : PHOEBE     MOSES      FRANCESCA  DOROTHEA   ERMA      
SHIRLEY    : ROSALIE    TIMOTHY    HINTON    
AURELIA    : WOLFE      PATEL      JAMAR      FRANKLIN  
POPE       : PERCY      OLA        BATTLE     TANYA     
VICTOR     : CINDY      CONSUELO   CROSBY    
DANIELS    : SIMON      NEWMAN     ART        GOODMAN    DAMON     
MARTHA     : DORIS      CRAIG      SIMONE     EARNEST    HOLLAND   
BRIANA     : INES       BUTLER     BOYD       FLORENCE   MERCER     HUFFMAN    CHUCK      FRANCISCO 
REYNA      : MADELINE   YANG       CALVIN     POOLE     
QUINCY     : STEPHENS   STEFANIE   MOSS       RICHARDS   STANTON   
HOLDER     : JOHNATHAN  COOK       MARCUS    
NAPOLEON   : ART        AVERY     
GABRIELA   : TRENTON    SALINAS    BRENTON    COMPTON    TRENT     
BETHANY    : NETTIE     GERARDO    HUFFMAN   
SHEPARD    : FRANKS     KATHARINE  GREGORY   
LAUREL     : PITTMAN   
FLORENCE   : VILMA      ALVAREZ    BRIANA     OMAR       IRVIN     
ROSA       : MCKEE      EMILY      MICHAEL    CLINT     
HAROLD     : FIELDS     RYAN       CLAUDIA    STANLEY   
SANDOVAL   : PEARSON    ROSETTA    MARYANNE   AISHA     
HENRIETTA  : HENRY      ROYCE     
WHITFIELD  : FOREMAN    ROSALINDA  JAY       
CLARA      : LYMAN      INGRID     PAYNE      WHITNEY    KERRI     
FULTON     : REEVES     RUTLEDGE   ROCCO     
ROBIN      : WARD       KRISTOPHER COLLIN    
WALTER     : THOMAS     STEVEN     ELDON      OTTO       RACHAEL   
JANINE     : WEEKS      HOPKINS   
BENTLEY    : PARRISH    IRA        MARKS      DARIN     
JASPER     : LEWIS      MASSEY     BURRIS     BARBRA     DEAN      
ERNESTINE  : ODELL      MILLICENT  KENDALL    RODGERS   
GARZA      : ROSE       MARA       RICARDO   
EVANGELINA : LESTER     JOHANNA    WYATT      AUSTIN     BENTON     ROOSEVELT  ISIDRO     WHITE     
EVANGELINA : GEORGIA   
SHAWN      : CHARLOTTE  STRICKLAND MCMAHON   
INGRID     : BUCK       CLARA      HOWELL    
LINDA      : PRINCE     LEONOR     PITTMAN    HENRY      ARTHUR    
SIMS       : OMAR       SWANSON    AYALA     
MURIEL     : TODD       DODSON     DALE       BRENTON    HOUSE     
ANNETTE    : BYRD       RICE       ALEXANDRA 
LORIE      : MCNEIL     PAMELA     EDMUND     ERNIE      GALLOWAY   VAUGHN    
MYRA       : CAITLIN    MARYANNE   CUNNINGHAM MAYS       MALLORY    WINFRED   
GLASS      : MCFADDEN   PECK       QUINTON   
LINDSAY    : ODELL      GONZALEZ   DELANEY   
ROBT       : GILMORE    HERRERA    VERA       BARKER    
PRUITT     : ANNA       MCMILLAN   MADDEN    
FOSTER     : FOX        AVIS       SCHULTZ    DECKER    
VINCENT    : MARIANA    MILDRED    TONI      
NOELLE     : SHERYL     KEITH      ROWE      
GOODMAN    : DANIELS    CORNELIUS 
RYAN       : HAROLD     RONNY      CHUCK      POOLE     
RICHMOND   : MCNEIL     JOHANNA    MATTHEWS  
LUCAS      : SNOW       ESTELLA    ALFONSO    KRYSTAL    WELDON    
DYER       : CASTILLO   LEANNE     JORDAN    
RUSSELL    : CECELIA    HENDRIX    COLLINS    HAYDEN    
BOB        : JEFFERSON  BONITA     SUAREZ     SANTANA    FLYNN      POLLARD   
MARIANA    : HUBER      VINCENT    GILES      SAVANNAH  
CRANE      : CRISTINA   DONA       CLEVELAND  CAIN       LOGAN     
ADELINE    : ABRAHAM    BURRIS     LARSON     COFFEY     MORENO    
GINGER     : MARION     RICKY      TY        
NANNIE     : ANDREA     DEANNE     NORMA     
MALLORY    : JEFFERSON  FLORES     MYRA       COMPTON    MILDRED    HARRIET   
REESE      : BULLOCK    JACKSON   
WILBUR     : IGNACIO    SEBASTIAN  STANTON    SHARRON    HERRING   
CLEVELAND  : SONYA      CRANE      MCINTYRE  
HOLT       : HOBBS      PITTS      SILAS      DONNA      GARNER    
LEONEL     : LATONYA    DIANE      LORRAINE  
BOOTH      : MACDONALD  FREDERICK  ANASTASIA  FLYNN     
FERN       : RICHARDS   ROSS       MACK       HOGAN      BEASLEY   
CALDWELL   : MARYELLEN  CASEY     
WILFORD    : HORTON     MARY       WILEY      SANCHEZ   
HENDERSON  : HERBERT    JIMENEZ    KRISTIE    LON       
LANCASTER  : SPENCE     FARLEY     ROJAS      NAVARRO    BEASLEY   
MARGARITO  : BLEVINS    ED         JESSICA   
BOLTON     : HUNTER     JARVIS     SEBASTIAN  WELDON    
BRUCE      : WOODWARD   AL         LORI       JOSE       TORRES     CHARLENE  
DENNIS     : WIGGINS    DANIEL     MONA      
HAYS       : CHAN       SUSAN      VALENTINE 
SUZETTE    : DAVENPORT  JEANNE     KANE      
BROWN      : WILLIS     VERNON    
KELLEY     : WILCOX     CAROL     
RODRIQUEZ  : KATY       JANELLE    THELMA     PHILLIP   
JERALD     : BURCH      VALENTINE  BARR       SHERMAN    HOOD       ROTH       KEVIN     
DELACRUZ   : RICO       ROD       
FREDRIC    : ROSETTA    CARMINE    RONNY      MICHAEL    MONROE    
ANA        : TILLMAN    JULIO      ELINOR     DEAN       HAYDEN    
JIMMIE     : FLEMING    DAVID     
MYERS      : VERA       KATHARINE  LE         STEVENSON 
EARL       : ALBA       CHANG      AMANDA     WILLIE    
VIRGIE     : STARK      SYKES     
STEVEN     : WALTER    
ANTONIA    : PAMELA     CARSON     CAROLINE   TANIA      MERRITT   
LIZZIE     : VELMA      NICHOLS    BOBBIE     TOWNSEND  
CATHRYN    : WALTON     MEREDITH   BEASLEY   
MARGERY    : ALVIN      GARNER     SHANNON    SAVANNAH  
SNOW       : LORENZO    LUCAS      TIMMY      MACK      
WISE       : SARA       HENDRIX    GIBSON     HALL      
AUGUSTINE  : HINTON     KRISTEN    MINNIE    
GLORIA     : ANITA      HENDRIX    KEVIN     
CONTRERAS  : LAURI      ROMAN      VARGAS     DANIEL    
FLEMING    : JIMMIE     BOYLE      KENTON     REGGIE     BAUER     
CAMERON    : BLEVINS    JEREMY     GENARO    
ESMERALDA  : CONRAD     BRIGITTE   HAWKINS   
HICKS      : HERBERT    REEVES     CARISSA    RUSS       MCCARTY    RANDALL    HEAD      
OMAR       : ROBBY      BOYD       FLORENCE   SIMS       JOSUE      EVE       
GEORGE     : PENNINGTON WILL       VICKY      CANTRELL   BEASLEY    HUNT      
AURORA     : SAMUEL     BRADSHAW  
PRISCILLA  : DARRELL    BURCH      DUNCAN    
CALLAHAN   : LEONARDO   GLADYS     STEPHENSON TRENT     
ROSEMARY   : LUCIEN     LEWIS      FREEMAN   
FRANCIS    : CHRISTI    KNOWLES    JOHNATHAN  NIGEL      CARLO      LORAINE   
TAMMY      : COLLIER    LACY       ANASTASIA  STACY     
LEANN      : RICHARDSON ODONNELL  
ERICKA     : VALERIE    ESTEBAN    MCGOWAN   
JANETTE    : JORDAN     MCMAHON   
EARLENE    : TIMMY     
JACOB      : THELMA     PETERSON  
CONNER     : GLENN      HARDY      CHERRY    
DELMAR     : JOHN       ODESSA     DERICK     JESSE      NIEVES    
TATE       : LUNA       DECKER     KASEY      HUNT      
KIP        : EVERETT    WELLS      MARSHALL   HAYDEN    
WALLS      : JORDAN     KURT      
NIKKI      : WELLS      SHANNON    BARNETT    LORAINE   
GUTHRIE    : HURLEY     RODRIGUEZ  MORENO    
ASHLEE     : OLGA       ERIN       HODGE     
MASSEY     : MCKAY      CLAYTON    SILAS      CAROLYN    JASPER    
TOMMY      : WYATT      MILES     
STEVENS    : WALSH      AUTUMN    
COLLEEN    : ROSETTA    RICHARD   
VEGA       : OSCAR      LELIA      NITA       KIDD      
TERRY      : KRISTIE    QUINN     
NORA       : DEWAYNE    SHELLEY   
JESSE      : PERRY      WILCOX     ROBBIE     DELMAR     SANTANA   
ASHLEY     : ROBBIE     AGNES      TRUDY      INA       
BERNADETTE : BETTE      BERTIE     HOMER      HERRING   
TIMMY      : KATY       PICKETT    EDGARDO    SNOW       EARLENE    CARROLL    GEORGIA    GAY       
JANICE     : LOTTIE     LUPE       FRANCES    ERNA       SALVATORE 
MONTOYA    : EMORY      LYDIA      MILDRED    JOHNNIE   
EFREN      : GARTH      PAYNE      ROOSEVELT  BERNADINE  CAROLE    
HERIBERTO  : MOSES      RIVERA     SHARON     BOYLE      JOHNSON   
SHARON     : CLEMENTS   WELCH      SPENCE     JACLYN     KLINE      HERIBERTO 
JUANITA    : LETITIA    TILLMAN    LEONARDO   MARCI     
AHMED      : FOREST     JOHNS      HEIDI      AUBREY    
CARR       : ERICKSON   DELBERT   
JARROD     : MERCEDES   OCONNOR    POOLE      RAUL      
STEWART    : CONNIE     KEVIN     
RAY        : PICKETT    JEFFERSON 
TRAN       : HORTON     JARRED     LEMUEL    
MCCORMICK  : TABATHA    RAYMOND    ERMA       HAWKINS   
JUAREZ     : NOE        WENDY      TRAVIS    
VALENTINE  : IRIS       WIGGINS    KERI       HAYS       JERALD     CHANCE     ROBERTSON 
SERRANO    : TRICIA     ROBINSON   COOLEY    
DUKE       : SIMON      CLAY       TREVINO    COFFEY     FERDINAND 
HECTOR     : CASE       MIKE       NIGEL      DUNLAP    
LACY       : WARREN     CLAYTON    ELVIRA     TAMMY      JOHNSTON  
AVERY      : BERT       CHELSEA    NAPOLEON   MCCRAY     RODERICK   PALMER     LORAINE   
MELBA      : BENJAMIN   NICHOLS    WILKERSON  MARCEL     MONROE    
GOLDIE     : COOK       CHANDLER   MORENO    
ISIAH      : LUCIEN     FIGUEROA   JAYNE      OWEN      
JEREMY     : FRYE       CAMERON    MARKS      DARIN     
BARBER     : RICO       ROXANNE    SALINAS    HOUSE     
LOWE       : TRACEY     HODGE     
ALFONZO    : VILMA      COLEMAN    BRYAN     
BUCKLEY    : DEJESUS    KATHARINE 
CRAIG      : DEWAYNE    MARTHA    
ROBBINS    : LANDON     ALI       
MABEL      : SYDNEY     CAROLINE   DIXON      WINFRED   
RUSS       : ELVIRA     HICKS      BRADLEY    MOHAMED   
KIDD       : KIM        ENGLAND    MEDINA     RICO       WOODWARD   VEGA       HOMER      GIBBS     
FAULKNER   : MARCY     
SAMPSON    : CECELIA    PALMER    
ANDREWS    : BONNER     ALFRED     WATTS      CORTEZ     AIDA      
SALINAS    : BEST       VASQUEZ    GABRIELA   BARBER     THADDEUS   REGGIE    
DELANEY    : WILLARD    CARLSON    ROMERO     MILLIE     LINDSAY    BASIL     
AVA        : COLLIER    WILLIE     HOGAN     
NEIL       : CHARLOTTE  BRIDGETTE  LORI       DAVID     
RAYMOND    : MCCORMICK  BRANDI     KRAMER    
BUCHANAN   : IRA        BLAIR      CARVER     FORREST   
EMILY      : MCCULLOUGH LOTTIE     ROSA       HOUSE      RODERICK   DEVON     
CONCEPCION : LORENZO    DUNCAN     ERNA      
KAUFMAN    : STACIE     BURTON     QUINN      CARDENAS   HAWKINS   
BRADLEY    : RUSS       MITCHELL   OBRIEN     ROTH      
JAYNE      : ANITA      FROST      ISIAH     
SIMONE     : LEACH      CHARLOTTE  TYREE      MARTHA     DARRYL    
SHEPHERD   : PAGE       CONNIE     OLA       
WILLIAMS   : BARRERA    CARNEY     ARNULFO   
MCINTYRE   : CANDICE    MAGGIE     CLEVELAND  MERRILL   
WILKINSON  : DORIS      LEVI       PAT        LE         HARPER    
CAROLINE   : BETTE      ANTONIA    MABEL      ERICKSON  
HOMER      : BERNADETTE KIDD       HUNT      
PARRISH    : PAGE       BENTLEY   
COX        : NUNEZ      CARSON     WHITNEY    GATES     
STACI      : LESLIE     WOLFE      COFFEY    
JACOBS     : BERT       GRETA      TABITHA   
ROSARIO    : SARGENT    ELIJAH     GATES     
MEADOWS    : MARYANNE   HUGH       DELGADO    LOTT       ODONNELL  
BRADSHAW   : ROBBY      ROXANNE    AURORA     BAUER     
MUELLER    : RAMOS      YANG       SCHNEIDER  WOLFE      RAPHAEL    CLARENCE  
HAZEL      : ERIK       ALBERT    
JARRED     : TRAN       KARLA      BENTON     STANTON   
BRUNO      : JACKSON   
SWANSON    : BERT       BOBBIE     SIMS      
CARROLL    : DEENA      EDMUND     CAMACHO    TIMMY      HENRY      TABITHA   
VALENCIA   : WOLFE      BEACH      LAWSON     CASEY     
PRESTON    : TAYLOR     KRISTINA   SAMUEL     RANDALL    JOAN       ERNA      
PEREZ      : BENJAMIN   ANTHONY    LIDIA     
MARCELO    : BLANCHARD 
MILLS      : HAMILTON   CLEMENTS   DAVENPORT  KELLER    
GENEVA     : SYDNEY     TABATHA    BURT       JOANNA     LARSON    
ERMA       : JOHNS      KRISTOPHER TIMOTHY    CHERI      DOMINGO    KATHLEEN   MCCORMICK  GILES     
TINA       : HARRELL    GERARDO    GARNER     BARBRA     ALBERT    
TOWNSEND   : LUCIEN     SWEET      LIZZIE     JOSE       TERENCE    ONEIL      MAYNARD   
BRENTON    : GABRIELA   MURIEL     CALVIN    
DELORIS    : MCKEE     
CANTU      : MARISOL    HOBBS      DEANNE    
PAYNE      : ODESSA     KATHARINE  CLARA      EFREN     
ANTHONY    : PEREZ      SONNY     
DELGADO    : IGNACIO    MEADOWS    JOAN      
MCCRAY     : BARRY      BETTE      SEARS      AVERY      PHELPS    
FREEMAN    : DIANE      FRANCESCA  ROSEMARY   LORAINE   
ESTEBAN    : INES       HARRINGTON BERT       ERICKA     ELDON      ROTH      
GRACE      : COPELAND   SILVA      WEAVER    
ADAMS      : HORTON     DARNELL    HANEY     
RICKY      : MARIBEL    GINGER    
LORENA     : WATERS     BRANDI    
KARLA      : FRANKS     JARRED     SARGENT    JAMEL     
WOODARD    : RUSSO     
JARED      : LEANNE    
WELLS      : TRICIA     BONITA     KIP        NIKKI     
NEWTON     : HENSON     NORMA     
BURRIS     : CLYDE      JASPER     ADELINE   
MARCY      : CLAY       FAULKNER   BENTON     HARRISON  
BENITO     : WALDO      DONNY      ERICKSON   ALBERTO   
LARSON     : FANNIE     ISABELLE   NITA       ADELINE    GENEVA     HODGE      JOHNSON   
VICKI      : OLGA       HURLEY     LETICIA    AUBREY     CORINNE   
DONALD     : COLON      NICOLAS    BONITA     GREGORY   
WENDY      : BURGESS    CARLENE    JUAREZ     MENDOZA    JOSUE      CARDENAS   BOWEN      WONG      
AUBREY     : JIMENEZ    BRIAN      AHMED      VICKI      HOWARD     BARNETT   
DAVID      : OLA        JIMMIE     NEIL      
COMPTON    : KATY       GERARDO    GABRIELA   MALLORY   
PUGH       : CORRINE    HARPER    
MENDOZA    : DARYL      DONNY      EMILE      WENDY      CAROLE    
KEITH      : JORDAN     NOELLE     JOYNER     GILBERTO  
MERLE      : MAXWELL    ROWE      
BREWER     : TOM        CARISSA    TANIA      WATTS      OLSEN      TONIA     
VERNON     : OLA        FLORES     LEVINE     BROWN      RONNY      ERNA       HOWARD    
SCOTTIE    : CASTILLO   LUCIANO    ROCKY      RODERICK  
ALICIA     : KURT       CANDY      KNIGHT     LINDSEY   
EARLE      : DINO       STEELE     DENA      
IAN        : CHRISTI    FOREST     LYMAN      CHARMAINE  BAUER     
JEAN       : NITA       PATRICK   
SAUNDERS   : MARCELINO  SLOAN      MILLICENT  GIBSON     KENTON    
DECKER     : LUNA       WELCH      FANNIE     FOSTER     TATE       WALLER    
JOSUE      : GILBERT    THURMAN    OMAR       WENDY     
SYKES      : HANSON     IGNACIO    VIRGIE     GUZMAN    
MILDRED    : COOK       VINCENT    MALLORY    MONTOYA   
SYBIL      : BAKER      BUTLER     HORN       SOFIA     
DEANNE     : NANNIE     CANTU     
BONNER     : PERRY      ANDREWS    HOUSE      ALINE     
NIELSEN    : TRENTON    WALTON     NORMA      DARIN      CLARENCE  
ENGLISH    : PAGE       RAMIRO     VARGAS    
HOUSE      : ANITA      BENNIE     MURIEL     BARBER     EMILY      BONNER     NORMA      BARBRA    
LEONARD    : SILAS     
WATERS     : STACIE     CONLEY     JOANNA     LORENA     FORREST   
BENTON     : LUCIANO    EVANGELINA JARRED     MARCY      BARR       PASQUALE  
HARMON     : THELMA     BRENDAN    FRY        WILL       DELBERT    LESSIE    
DIXON      : MARISOL    JOHANNA    RASMUSSEN  MABEL      CLARENCE   ROTH      
ISABELLA   : JACKIE     EMILE     
GARNER     : BALDWIN    MCKEE      HOLT       MARGERY    TINA      
MOODY      : RASMUSSEN  RICARDO    ORTIZ      STEVENSON 
LUISA      : AMANDA     DEWITT     NELDA     
PUCKETT    : HATFIELD   ALVIN      JIM        VANCE     
WALL       : BELL       ORTIZ     
DEMETRIUS  : PASQUALE  
MOHAMED    : LEBLANC    RUSS       FERDINAND  HOLLAND   
GIBSON     : WISE       SAUNDERS   LANG      
SOLOMON    : CARDENAS   ALFONSO   
GOOD       : KNOWLES    ROCKY      CASSIE    
ELVA       : AVIS       REUBEN    
NIEVES     : GALEN      DELMAR     BURKS     
JEWELL     : CAROLYN    SUSAN      LE         ALISSA    
JOSE       : BRUCE      TOWNSEND   KRISTEN   
DIXIE      : DIANE      MCLEAN     MARISSA   
GRAY       : CHERI     
FULLER     : JEFFERSON  EMORY     
ELDON      : CORY       WALTER     ESTEBAN   
JESSICA    : MARGARITO  CEDRIC    
GILLESPIE  : LENARD     MILES      KEVEN      BATTLE     MCMAHON   
ALEXANDRA  : HARRINGTON HIRAM      HOPKINS    ANNETTE    JAY        SAVANNAH   ALBERT    
IRA        : BENTLEY    BUCHANAN   WALLER     RAUL      
BIRD       : BERT       CAROLYN    RODGERS    TYLER     
TAMMIE     : MCCALL     LANE       TREY       LIDIA     
RORY       : DEANDRE    CHAVEZ     MONA      
MERCER     : KATY       FORBES     BRIANA     CORINNE    ROSALES   
STANTON    : RUTLEDGE   QUINCY     WILBUR     JARRED    
GRACIELA   : OSCAR      TRACEY     JAIME      LEON       GRAHAM     DANIAL    
COLLIN     : FRY        ROCKY      ROBIN      DURAN      LE        
BOBBI      : GARRETT    LUCIANO    CARMELO    LEVINE     CUMMINGS  
MARKS      : HOUSTON    JILL       LARSEN     MARGUERITE ETTA       BENTLEY    JEREMY     ARNULFO   
ADKINS     : ANIBAL     LAMBERT    DOMINGO    HUBBARD   
HERMAN     : FREDERIC   NICHOLS    KENDALL    EVERETT   
IRVIN      : NICOLAS    FLORENCE   JILLIAN    KRAMER    
PATRICK    : CRAFT      ARMSTRONG  JEAN       FUENTES   
VALENZUELA : GONZALEZ   MALDONADO 
WILKERSON  : MELBA      GALLAGHER  ENID      
ANTONIO    : HERBERT    LEANNE     AUTUMN     CHANCE    
HERSCHEL   : BAKER      RICE       LEONARDO   PETER      KENTON    
DWIGHT     : WALTON     RAMIRO    
HURST      : ANNA       HANSON     OBRIEN    
PAT        : JARVIS     WOODWARD   WILKINSON  DANIAL    
LAURI      : MARYELLEN  VERN       CONTRERAS 
HENRY      : HENRIETTA  LINDA      CARROLL   
MARSH      : BEACH      LANE       WILLIE     ROSALES   
NOEMI      : PAMELA     FRY        TERENCE    ERNIE      NOEL       LOGAN     
CHRISTIAN  : DUNCAN     BURKS     
SHANNON    : LILIANA    DEENA      MARGERY    NIKKI      PATSY      MOSLEY    
ARNULFO    : KRISTIE    MAGGIE     HANEY      WILLIAMS   MARKS      NADINE     WEBB      
SETH       : OLIVER     PEARSON    BENJAMIN   JACLYN     BARTLETT   CHARMAINE 
INGRAM     : ANNIE      HOLLAND   
ALFRED     : LATONYA    ANDREWS    ESTELLA   
CHRISTINE  : BELL       KRISTIE    ANASTASIA  OWEN       COLLINS   
CINDY      : GILMORE    VICTOR     JACKSON   
DAVENPORT  : CONLEY     SUZETTE    MILLS      MARIANO   
SANFORD    : DILLON     HINES      SEBASTIAN  HUFFMAN   
COLEMAN    : BRIGHT     ALFONZO    LENORA     DELBERT   
JIM        : GARRY      PUCKETT    WATTS      NADINE     GALLOWAY   MARVIN    
GENARO     : TODD       INES       REBEKAH    NICOLAS    ERIKA      MILES      CAMERON   
CORINNE    : DARCY      VICKI      MERCER     WHITNEY    FORREST    MACIAS    
ELBERT     : CHARLOTTE  DILLON     MARA       KENDRA     CAROLE    
DAREN      : PITTMAN    FROST      SAVANNAH  
YVETTE     : BARRY      HENSLEY   
MORROW     : LILA       WARNER     MOSES      REGGIE    
GUZMAN     : SYKES      DANIEL     WEBB      
NORMA      : NICOLE     PORTER     NANNIE     NEWTON     NIELSEN    HOUSE     
DAMIAN     : SUSANNA   
HUMBERTO   : LEBLANC    KERRI      BARNETT   
DICK       : WILLARD    MANN       SCHROEDER  JOHNSON    MAURICE   
SONNY      : STRICKLAND ANTHONY    TONIA     
MATHIS     : CECELIA    LATISHA    EVAN      
JULIET     : RASMUSSEN  FRANCES    ORTIZ     
KRISTEN    : DONOVAN    BYRD       AUGUSTINE  JOSE       DON        HARRIET   
SARGENT    : ROSARIO    KARLA     
MCCARTY    : LITTLE     DUSTY      HICKS      KENDRA     HOLLOWAY  
TANIA      : HOOPER     LEVI       ANTONIA    BREWER     CASTRO    
JULIE      : ALLISON    BRYON      BOYER      CANDY     
RONNY      : HOLDEN     PIERCE     RYAN       FREDRIC    VERNON    
HENDRICKS  : XAVIER     ROXANNE    FRANCESCA  SOLIS      BARTON     LESSIE    
BOWMAN     : MCKENZIE   SHANA     
HARRISON   : LEONARDO   LETICIA    MARCY      EDWIN      ALBERT    
DORA       : HOBBS      ROSEANN    DUNLAP    
ELIJAH     : MCKAY      ROSARIO    HALL      
ERICKSON   : MONTY      STEFANIE   CARR       CAROLINE   BENITO    
TEDDY      : MCDONALD   OCONNOR    CLARK      GRETA     
REFUGIO    : PHILIP     KOCH       THADDEUS  
LOTT       : MEADOWS    SIMPSON    MARTIN    
WATTS      : MCNEIL     STACIE     SANTIAGO   CARLENE    ANDREWS    BREWER     JIM       
GILES      : CHELSEA    MARIANA    ERMA      
VAN        : MEREDITH   DALE       KENTON    
BULLOCK    : CECIL      REESE     
GOODWIN    : VILMA     
TORRES     : ODESSA     BRUCE      ROD        RANDOLPH  
WALLER     : GLENN      TAMMI      DECKER     IRA       
RAPHAEL    : STARK      MUELLER   
ELLIOTT    : CORY       TERRI     
MACDONALD  : ERIN       MORRIS     BOOTH      OBRIEN    
JAMAR      : WARD       RICARDO    AURELIA    GLOVER    
LEMUEL     : LITTLE     TRAN       ADDIE      HOLLAND   
DARIN      : BOBBIE     BENTLEY    JEREMY     NIELSEN   
ROJAS      : BONITA     ROY        LANCASTER 
BOYLE      : DEANA      FLEMING    HERIBERTO  BLAIR     
KENTON     : MCNEIL     STRICKLAND MOSS       FLEMING    SAUNDERS   HERSCHEL   VAN        KASEY     
KENTON     : JOYNER    
MOISES     : BYRD      
AUTUMN     : CRYSTAL    FLETCHER   ALTA       STEVENS    ANTONIO   
ROOSEVELT  : EVANGELINA EFREN     
QUINN      : HUGHES     LARSEN     BURCH      CATHERINE  TERRY      KAUFMAN   
NAVARRO    : KRISTOPHER LANCASTER  SELLERS   
FAITH      : EMORY      SIDNEY    
CAIN       : ISRAEL     DARCY      ODOM       BARKER     CRANE      ERIK      
CHANCE     : IVANA      CHARLIE    NOE        BOYER      VALENTINE  ANTONIO   
BRANDI     : RAYMOND    LORENA     ROBERTSON 
ROSALINDA  : DINO       BENNIE     WHITFIELD  MANNING   
PATSY      : WILCOX     SCHNEIDER  MANUEL     SHANNON    MILO      
SOSA       : KENDALL    PORTER     CHARLENE   FUENTES   
HODGE      : ASHLEE     LOWE       LARSON     ALISSA    
NANCY      : LATONYA    HINES      RIVERA     MICHEAL   
LON        : SUAREZ     DAWN       HENDERSON  HUBBARD   
TERRELL    : VICTORIA  
MERRITT    : ANTONIA   
MATTHEWS   : DEANA      RICHMOND   HOOD      
CEDRIC     : MARCUS     JESSICA    CARDENAS  
MAXINE     : BAIRD      ALEXANDER  WIGGINS    ARTHUR     MARSHALL   NATASHA   
SUSIE      : ALBA       CORY       AL         SONYA     
HALL       : LAMBERT    WISE       ELIJAH    
ALYSON     : HANEY      AL         HARRIS    
CHERRY     : MEDINA     RASMUSSEN  CONNER     BLAIR     
CORTEZ     : ANDREWS    MACIAS    
EVAN       : MATHIS     BAUER     
PHILLIP    : RODRIQUEZ  MITCHELL  
SUSANNA    : RICO       CLAY       DAMIAN    
MANNING    : KATHERINE  RICE       ROSALINDA  EARNEST   
CARDENAS   : MEREDITH   HAMILTON   KAUFMAN    WENDY      SOLOMON    CEDRIC    
OTTO       : BEAN       ENGLAND    ALTON      KRISTINA   WALTER     JACKSON   
KYLE       : HUNTER     AIDA      
EARNEST    : MARTHA     MANNING    MICHAEL   
OLSEN      : GILBERT    ROY        BREWER     ROMAN     
WILLIE     : PETER      BARKER     EARL       AVA        MARSH     
SCHROEDER  : THOMAS     SUAREZ     DICK       ALINE     
TONI       : RASMUSSEN  VINCENT   
BILLIE     : MADELINE   JAMAAL     MERCEDES   CHARITY    AMELIA     MARTINEZ   CLEMONS   
OLSON      : MCNEIL    
ESTELLA    : HINES      SLOAN      LUCAS      ALFRED     DANIEL    
ALBERTO    : BENITO     FORREST   
SHARRON    : LILIANA    WILBUR    
EDWIN      : HARRISON   HILL      
WHITNEY    : STEPHENS   KIM        VERN       CLARA      COX        CORINNE   
CURRY      : EUGENIA    STRICKLAND JOHNSTON  
HUFFMAN    : WARNER     COMBS      BRIANA     BETHANY    SANFORD   
TERENCE    : WALTERS    TOWNSEND   NOEMI      ERIK      
SANTANA    : TIMOTHY    SIDNEY     BOB        JESSE      DANIAL    
ROMAN      : RODNEY     CONTRERAS  OLSEN     
KENDRA     : ELBERT     MCCARTY    MOSLEY    
PETERSON   : JACOB     
ROD        : TOBY       MOLINA     DELACRUZ   TORRES    
BASIL      : JENNINGS   DELANEY    LEROY     
RICK       : BRIGHT    
MICHAEL    : MIKE       ROSA       FREDRIC    EARNEST   
BATTLE     : SHANA      POPE       GILLESPIE  ISIDRO    
COTTON     : SEARS      SARA       RICHARDSON
BERNARDO   : AVIS       JOHNS      KARYN      ROSEANN   
WASHINGTON : COLLIER    GIBBS     
JILLIAN    : FREDERIC   MCMILLAN   DANIELLE   IRVIN      TONIA     
TERRENCE   : BARTLETT   ENID       LUCY      
HERRING    : DONOVAN    VELASQUEZ  WILBUR     BERNADETTE RICHARDSON CONSTANCE  TY        
FREDERICK  : BOOTH      MARISSA   
DYLAN      : VALERIE    ALBERT    
SIMPSON    : DENIS      EVERETT    LOTT      
BRADFORD   : BRADLY     TIMOTHY    SCOTT      BARBRA     REGINA    
ERIK       : CHANEY     ISSAC      OLA        HAZEL      CAIN       TERENCE   
CALVIN     : FOREST     DILLON     CLYDE      CAROLYN    REYNA      BRENTON   
MARIANO    : VELMA      DAVENPORT 
BARR       : MEDINA     JERALD     BENTON    
ORTIZ      : MOODY      WALL       JULIET    
DON        : LAUREN     ROBBY      EDMUND     ROXANNE    LUPE       KRISTEN   
THADDEUS   : STEFANIE   SALINAS    REFUGIO   
SCHWARTZ   : HATFIELD   OCTAVIO    LOTTIE     TERRI     
AYALA      : LANA       CARSON     SIMS      
HUDSON     : MERCEDES   KIM        CUMMINGS  
TRUDY      : MICAH      ASHLEY     KASEY     
ARTHUR     : PHILLIPS   SELENA     AMELIA     CAROLYN    LINDA      MAXINE     LOGAN     
COFFEY     : STARK      MARTINEZ   ADELINE    DUKE       STACI     
MAYER      : LEACH      NICOLE     NADINE     TANNER    
NADINE     : LANDON     REEVES     CANTRELL   SARA       ARNULFO    JIM        MAYER      FRANCISCO 
NADINE     : QUINTON   
DUNCAN     : KNOX       FRYE       PRISCILLA  CONCEPCION CHRISTIAN 
REGGIE     : ISABELLE   THOMPSON   FLEMING    SALINAS    MORROW     KANE      
BLAIR      : BUCHANAN   BOYLE      CHERRY     KERRI     
SHERMAN    : CECELIA    JERALD    
LENORA     : WALDO      BURTON     COLEMAN    CONSUELO   CLAUDIA   
CHUCK      : BRIANA     RYAN       SHERRI    
GATES      : LUNA       CHANDLER   COX        ROSARIO    LE        
SOFIA      : HOLMAN     SYBIL     
FERDINAND  : DUKE       MOHAMED   
ISIDRO     : EVANGELINA BATTLE    
KELLER     : WARD       FLORINE    MILLS     
CANDY      : GOMEZ      BALLARD    ALICIA     JULIE      DUNLAP    
JAY        : KENT       ADAM       WHITFIELD  ALEXANDRA  ALFONSO   
TURNER     : DUNLAP     EVANGELINE
MUNOZ      : WILFREDO   HEWITT     CROSBY    
VARGAS     : WILLARD    SILAS      ED         CONTRERAS  ENGLISH    BARTON    
WENDI      : DIONNE     MACIAS    
RANDALL    : DORIS      HICKS      PRESTON    JOSEPHINE 
JOAN       : HOUSTON    CARSON     PRESTON    DELGADO   
ERNA       : CLAYTON    TASHA      SCOTT      JANICE     CONCEPCION PRESTON    VERNON    
VANCE      : VONDA      PUCKETT   
AMADO      : ARRON      HUNTER     DONA      
CARVER     : STOUT      BUCHANAN  
LACEY      : DIONNE     ELMA       WINTERS    RODNEY     STANLEY    ESTRADA   
INA        : MARISOL    HARDY      ASHLEY    
HARRIET    : JENNINGS   DONA       MALLORY    KRISTEN   
AISHA      : SANDOVAL  
ALI        : LITTLE     ROBBINS   
FORREST    : GUY        BUCHANAN   WATERS     CORINNE    ALBERTO   
ADDIE      : CRISTINA   ART        LEMUEL    
GALLAGHER  : VICKY      MOLINA     WILKERSON  LEON       DANA      
KNIGHT     : CHRISTI    ALICIA    
KRISTINE   : CHARITY    GARRETT    BRIGITTE   COLLINS   
ROBERT     : PAMELA     HORTON     NGUYEN    
CLARENCE   : FRIEDA     MOLLIE     MUELLER    NIELSEN    DIXON      PHELPS    
WHITE      : EVANGELINA
KERRI      : CLARA      HUMBERTO   BLAIR      ANGIE     
HOFFMAN    : SHANA      CARMELO    BETH      
TABITHA    : JACOBS     CARROLL   
DURAN      : URSULA     ROCCO      COLLIN    
CORNELIUS  : HOBBS      WIGGINS    GOODMAN   
HOWELL     : CANDICE    FLOSSIE    INGRID    
CHARMAINE  : FREDERIC   LUCIANO    VERN       IAN        SETH      
ERNIE      : PETTY      LORIE      NOEMI      BRYAN     
MARSHALL   : KIP        MAXINE    
HOOD       : JERALD     MATTHEWS   BOWEN     
HARRIS     : MOSES      ALYSON    
FRANKIE    : DEENA      KERRY      NETTIE    
LAWSON     : MERCADO    VALENCIA   REGINA    
DEWITT     : ETTA       ERIKA      VASQUEZ    LUISA     
LEON       : BONITA     GRACIELA   GALLAGHER  BRIDGET   
SANCHEZ    : COOLEY     BEST       WILFORD    DELBERT   
GONZALES   : SCHNEIDER  MARCI     
JEANNE     : SUZETTE   
LIDIA      : PEREZ      TAMMIE    
CUMMINGS   : CARNEY     FANNIE     KIM        BOBBI      HUDSON    
HAWKINS    : VELASQUEZ  TUCKER     ESMERALDA  MCCORMICK  KAUFMAN   
LE         : MYERS      WILKINSON  JEWELL     COLLIN     GATES     
ANASTASIA  : KRISTOPHER WILFREDO   BOOTH      TAMMY      CHRISTINE  BRAY      
ROYCE      : MONICA     HENRIETTA  CONSTANCE 
BURKS      : DEJESUS    NIEVES     CHRISTIAN 
FLYNN      : SEARS      BOB        BOOTH      MARCEL     CASSIE    
DALTON     : IRIS       DALE       MALDONADO 
STRONG     : KATHERINE 
CLINT      : MAGGIE     ROSA      
LORNA      : MONTY      GALEN      LETICIA    REGINA    
ENID       : CARNEY     WILKERSON  TERRENCE   STEVENSON  LEROY     
JACKSON    : ARIEL      REESE      BRUNO      CINDY      OTTO      
RICHARDSON : FREDERIC   COOK       LEANN      COTTON     HERRING   
BRYANT     : KATY       PASQUALE  
CLEMONS    : MARIE      FERNANDEZ  PORTER     BILLIE    
CHARLENE   : HINES      RIVERA     KERI       BRUCE      SOSA       PALMER    
ROWE       : ALVAREZ    BLANCHARD  NOELLE     MERLE      MILO      
REINALDO   : BELL       HEBERT     POTTS      LATISHA    NICHOLSON 
JOHNNIE    : TARA       MILLICENT  FORBES     MONTOYA   
TANYA      : LEONARDO   JOSEPH     KURT       POPE       TRAVIS     GALLOWAY  
COTE       : DONNA      HOLLIE     FRANCISCO 
POOLE      : ROBERTA    FREDDIE    WOLFE      REYNA      RYAN       JARROD    
ONEIL      : HIGGINS    FEDERICO   TOWNSEND   GEORGIA    BARNETT   
HELENA     : LEONOR     SWEET      GARTH     
HUBBARD    : PHOEBE     ADKINS     LON       
MARCEL     : REEVES     GRIFFIN    MELBA      FLYNN     
BRAY       : TRACEY     DIAZ       ANASTASIA 
DAMON      : DIONNE     DOYLE      DANIELS   
AIDA       : HOLCOMB    ANDREWS    KYLE      
BLAKE      : FLORES    
GEORGIA    : TRICIA     EVANGELINA TIMMY      ONEIL      DANIEL    
NELDA      : ALTON      LUISA     
GRAHAM     : RAMIRO     BOWERS     ROXANNE    RODRIGUEZ  GRACIELA  
HOWARD     : BLEVINS    TOM        BUTLER     MARCI      MARCUS     AUBREY     VERNON    
STEVENSON  : MCLAUGHLIN MYERS      MOODY      ENID       LLOYD     
STACY      : TAMMY      NICHOLSON 
CAROL      : GLENN      NICOLE     JODIE      KELLEY    
MADDEN     : JACKIE     AYERS      PRUITT    
ROSALES    : MERCER     MARSH     
ALISSA     : MARION     WITT       BETTE      JEWELL     HODGE      GAY       
RODERICK   : MICHEAL    AVERY      EMILY      SCOTTIE   
NOEL       : PETTY      BORIS      NOEMI     
MCLEAN     : MEDINA     HANEY      DIXIE      ETHEL      MERRILL   
CONSUELO   : CONNIE     VICTOR     LENORA    
CARLA      : AUSTIN     WILL       KERI       NATASHA   
KASEY      : TRICIA     JODIE      KENNEDY    TATE       KENTON     TRUDY     
MORENO     : BRIDGETTE  ADELINE    GUTHRIE    GOLDIE     KEVIN     
BARNETT    : CARLSON    WOLFE      NIKKI      AUBREY     HUMBERTO   ONEIL     
ANDREW     : SIMON      MCCONNELL 
SAVANNAH   : BLACKWELL  NORTON     MARIANA    MARGERY    ALEXANDRA  DAREN      MACIAS    
DUNLAP     : DAWN       HECTOR     DORA       CANDY      TURNER     BERNADINE 
MITCHELL   : DEJESUS    BRADLEY    PHILLIP   
HEWITT     : TRENTON    PERRY      BENJAMIN   MUNOZ     
BARBRA     : JACKIE     JASPER     TINA       HOUSE      BRADFORD  
JOSH       : JARVIS     ORR       
MILO       : PATSY      ROWE      
MACK       : GONZALO    FERN       SNOW      
ODONNELL   : WARREN     LEANN      MEADOWS   
JOHNSON    : HAMILTON   ABRAHAM    STUART     CASANDRA   STARK      HERIBERTO  LARSON     DICK      
MINNIE     : LESTER     DANIELLE   MOLINA     RODGERS    AUGUSTINE 
CASTRO     : ELOISE     FRANKS     HULL       LELIA      TANIA     
JAMEL      : LEE        EDITH      ROY        DOROTHEA   KARLA     
HOLLOWAY   : LYDIA      MCCARTY    GILBERTO  
LANG       : WALSH      KERRY      KENDALL    GIBSON     MAYNARD   
SALVATORE  : OCONNOR    STARK      JANICE     MARCIA    
RANDOLPH   : STOUT      ROSEANN    TORRES     DANIEL    
TRAVIS     : ELOISE     JUAREZ     TANYA      RAUL      
DEVON      : LUCILLE    SPENCE     THURMAN    EMILY      SHERRI    
FRANCISCO  : LENARD     BRIANA     NADINE     COTE      
CORRINE    : SOTO       HOPKINS    KURT       PUGH       RUSSO     
HOGAN      : HARVEY     TAMMI      FERN       AVA       
DANIEL     : FOX        HEIDI      DENNIS     CONTRERAS  GUZMAN     ESTELLA    GEORGIA    RANDOLPH  
ANGELITA   : QUINTON   
MARISSA    : HIRAM      VICKY      DIXIE      FREDERICK 
OBRIEN     : FOX        FIELDS     OSCAR      BRIDGETTE  CANTRELL   BRADLEY    HURST      MACDONALD 
OBRIEN     : KRYSTAL   
WINFRED    : WARD       VELMA      WELCH      ISRAEL     MILES      MYRA       MABEL      KRAMER    
CLAUDIA    : HOBBS      HAROLD     LENORA     MACIAS    
GIBBS      : COOKE      SEARS      BUTLER     BOBBIE     KIDD       WASHINGTON
FERRELL    : SCOTT      DEANA      BERGER     TANNER     LAWANDA   
ELINOR     : MCDONALD   MAGGIE     WEAVER     ANA        BARTON    
LUCY       : KATHY      PETER      TERRENCE  
GAY        : TIMMY      ALISSA    
MOSLEY     : CARLSON    SELENA     SHANNON    KENDRA    
FUENTES    : WARNER     WOODWARD   PATRICK    SOSA      
JULIAN     : CHARLOTTE  FRIEDA     KERRY      CAROLYN   
PASQUALE   : BENTON     DEMETRIUS  BRYANT     HELGA     
LEROY      : BASIL      ENID      
DELBERT    : PITTS      CORY       CARR       HARMON     COLEMAN    SANCHEZ   
DANIAL     : GILL       GRACIELA   PAT        SANTANA    MARTIN     ROTH      
PHELPS     : LESLIE     MCCRAY     CLARENCE   JOSEPHINE 
MAYNARD    : MCCULLOUGH MCFADDEN   GERARDO    TOWNSEND   LANG       KELLY     
JOYNER     : TRENTON    PHILLIPS   LENORE     KEITH      KENTON    
CURTIS     : WEBSTER    FREDDIE   
CONSTANCE  : JOSEPH     HERRING    ROYCE     
TANNER     : RAMIRO     REUBEN     MAYER      FERRELL   
KRAMER     : STACIE     RAYMOND    IRVIN      WINFRED   
MCGOWAN    : BLEVINS    ERICKA     GILBERTO  
SELLERS    : GILBERT    HART       TRACEY     NAVARRO    POLLARD   
SHELLEY    : DIONNE     JOHANNA    NORA      
ALFONSO    : FOX        PARK       LUCAS      SOLOMON    JAY        BAUER     
CROSBY     : WILCOX     MICHEAL    VICTOR     MUNOZ     
PARSONS    : DENIS      BROCK      FREDDIE    MARTINEZ  
HELGA      : LOTTIE     PASQUALE  
ALINE      : RAMIRO     BOYER      MAE        BONNER     SCHROEDER 
GALLOWAY   : HUNTER     ART        LORIE      JIM        TANYA     
LINDSEY    : NEWMAN     ALICIA    
JOSEPHINE  : CLAUDETTE  LOURDES    KATHARINE  PAM        RANDALL    PHELPS    
BERNADINE  : ENRIQUE    EFREN      DUNLAP    
OWEN       : SPENCE     GALEN      ISIAH      CHRISTINE  CASSIE    
CASEY      : WARNER     DALE       CALDWELL   VALENCIA  
TYLER      : RIVERA     BIRD      
MARCIA     : SALVATORE 
COLLINS    : SWEET      BUTLER     NEAL       RUSSELL    CHRISTINE  KRISTINE  
MONROE     : THOMPSON   HULL       FREDRIC    MELBA     
MARVIN     : PENNINGTON KIM        JIM       
DUFFY      : LULU       MERLIN    
JOHNSTON   : ALTA       SEARS      LACY       CURRY     
KELLY      : MAC        HANSON     MARY       MAYNARD   
RUSSO      : MILLER     CHAN       STARK      DONNA      SALAZAR    WOODARD    CORRINE   
BRIDGET    : DORIS      JESSIE     LEON      
LYNN       : TRACEY     ALVAREZ    CATHERINE 
BEASLEY    : MOSES      KERRY      REUBEN     DARCY      FERN       LANCASTER  CATHRYN    GEORGE    
ETHEL      : LUCIANO    CATHERINE  MCLEAN     SAVAGE    
MACIAS     : JENNINGS   CORINNE    CORTEZ     WENDI      SAVANNAH   CLAUDIA   
FINLEY     : BAKER      ROBINSON   DOYLE      ESTRADA   
BARTON     : BRYON      WIGGINS    HENDRICKS  VARGAS     ELINOR    
RUSSEL     : CLAUDETTE  HANEY      DIANE      PECK      
PALMER     : LILIANA    SELENA     AVERY      SAMPSON    CHARLENE   LAWANDA    LORAINE   
GLOVER     : BALLARD    DAVIS      LEVINE     JAMAR     
LAWANDA    : FERRELL    PALMER     RAUL      
EVE        : ISABELLE   OMAR       DANA      
GILBERTO   : DALE       LULU       KEITH      HOLLOWAY   MCGOWAN   
LLOYD      : STEVENSON 
HEAD       : HICKS     
PARKS      : LEANNE     MEDINA     SALAZAR   
MARTIN     : MCKENZIE   LOTT       DANIAL    
SAVAGE     : DEENA      ETHEL     
MAURICE    : AMIE       GARRY      NEAL       DICK      
STEPHENSON : MADELINE   MERCADO    BYRD       VICTORIA   TREY       CALLAHAN   KANE      
NICHOLSON  : HARDY      RITA       REINALDO   STACY     
BRIGGS     : PHILIP    
REYNOLDS   : EVERETT   
REILLY     : CHARITY   
EVANGELINE : GILMORE    PERCY      THOMPSON   TURNER     DEAN      
BRYAN      : ALFONZO    ERNIE     
NGUYEN     : ROBERT     MERRILL   
WEBB       : FOX        OLA        ERIKA      ARNULFO    GUZMAN    
ROTH       : ALTON      JERALD     BRADLEY    ESTEBAN    DIXON      DANIAL    
KANE       : LUCILLE    FLOSSIE    CARNEY     JORDAN     JOANNA     ABEL       SUZETTE    REGGIE    
KANE       : STEPHENSON
ALBERT     : PHOEBE     FRY        HAZEL      TINA       ALEXANDRA  HARRISON   DYLAN     
LESSIE     : DUNN       WEAVER     HARMON     HENDRICKS 
ANGIE      : KERRI     
DEAN       : CHARITY    JASPER     ANA        EVANGELINE
MCCLURE    : CAITLIN    LAUREN     ED         LEVINE    
STANLEY    : COOKE      LELIA      HAROLD     LACEY     
MCBRIDE    : KERRY     
HUNT       : LANDON     GEORGE     TATE       HOMER     
BETH       : JOHANNA    EMILE      HOFFMAN    KERR      
RENA       : AMELIA     CHANDLER  
ROBERTSON  : MARION     PIERCE     VALENTINE  BRANDI    
KEVIN      : HUNTER     JERALD     GLORIA     STEWART    MORENO    
KRYSTAL    : IVANA      COLLIER    LUCAS      OBRIEN    
WELDON     : BRIDGETTE  MILES      LUCAS      BOLTON    
ESTRADA    : LACEY      FINLEY    
GREENE     : COMBS      HIGGINS    MARIE     
MCMAHON    : AMIE       WALTERS    WEBER      SHAWN      JANETTE    GILLESPIE 
TRENT      : GABRIELA   CALLAHAN  
REGINA     : MILES      BRADFORD   LAWSON     LORNA     
POLLARD    : BOB        SELLERS   
QUINTON    : SOTO       MARA       NANETTE    GLASS      NADINE     ANGELITA  
CAROLE     : COOKE      MCLAUGHLIN EFREN      MENDOZA    ELBERT    
HOLLAND    : EUGENIA    MARTHA     MOHAMED    INGRAM     LEMUEL    
KERR       : BALDWIN    ERICK      BETH      
DARRYL     : RAMSEY     RUTLEDGE   SIMONE    
CHARLES    : MCCONNELL  SHERRI    
LOGAN      : FRYE       DENA       CRANE      NOEMI      ARTHUR    
CASSIE     : SPENCE     LES        GOOD       FLYNN      OWEN       WONG      
BOWEN      : ABE        ABEL       WENDY      HOOD      
HARPER     : GONZALEZ   LELIA      WILKINSON  PUGH      
FRANKLIN   : LUNA       BERTIE     AURELIA   
WONG       : BELL       CORY       WENDY      CASSIE    
MERRILL    : MCINTYRE   MCLEAN     NGUYEN    
MONA       : JARVIS     DENNIS     RORY      
TONIA      : BURTON     BREWER     SONNY      JILLIAN   
DANA       : BARLOW     WINTERS    SARA       GALLAGHER  EVE       
ANNABELLE  : BAKER     
TY         : LORENZO    LENORE     CARMINE    GINGER     HERRING    PETERSEN  
HILL       : TRACEY     ART        DUSTY      EDWIN     
BAUER      : OCONNOR    ORR        FLEMING    BRADSHAW   IAN        EVAN       ALFONSO   
TRACY      : ODESSA     ISABELLE   SUAREZ     RODGERS    ZAMORA    
HAYDEN     : PEARSON    RUSSELL    ANA        KIP       
NATASHA    : JANELLE    MAXINE     CARLA     
RAUL       : FRANKS     JARROD     IRA        TRAVIS     LAWANDA   
VAUGHN     : PITTMAN    REYES      LORIE     
LORAINE    : FOREST     FRANCIS    NIKKI      AVERY      FREEMAN    PALMER    
RACHAEL    : ALVIN      COOKE      NETTIE     WALTER    
SHERRI     : NOLAN      CHUCK      DEVON      CHARLES   
PETERSEN   : MERCADO    ABRAHAM    EDMUND     TY        
