OLGA       : ABE        BRADLY     CAROLYN    BUDDY      HERMAN    
ROB        : HEIDI      DECKER     MILDRED    QUINN     
DORIS      : MCCRAY     BONNER     OLSEN      LOGAN     
WILLARD    : BLEVINS    YOUNG      LAMBERT    JANICE    
COLON      : WATERS     ERIK      
MAVIS      : KRISTIE    REGGIE     ONEIL      SHERRI    
LANDON     : VERA       MARGUERITE KURT       MARCEL    
KATHERINE  : WINTERS    RODRIGUEZ  BRIANA     VICKI      HARRIS    
PAGE       : BENJAMIN   GLORIA     CARROLL    WILKERSON  CASEY     
HOOPER     : HUNTER     VALENZUELA AUTUMN     BRADFORD  
OLIVER     : CHANEY     NIGEL     
CASTILLO   : CANDICE    RODNEY     REYNOLDS  
TRENTON    : CALVIN     TURNER     JEANNE     POOLE     
RAMSEY     : VALERIE    GRIFFIN    PITTS      DARCY      GOODMAN    PARKS     
VILMA      : HORN       SOLIS      LEONEL     LUISA      KYLE       BARR      
MCDONALD   : VASQUEZ    GRETA      HELGA      BERNADINE 
PEARSON    : WEISS      DONNY      SARA       KENTON     KELLER     JOHNSTON  
WALTON     : SYDNEY     CECELIA    CHERRY     DEWITT     HELENA    
CARLSON    : ANDERSON   PECK       ASHLEE    
MARISOL    : JOSEPH     SNOW       DAMON      REGINA    
LESTER     : LESLIE     KNOX       SAM        NORTON     RUSSO     
MANN       : ODELL      FRANKS     TAMERA     ROXANNE   
PERRY      : RUSSELL    COFFEY    
KATY       : JOHN       JORDAN     RODGERS    ERICKSON   HEWITT    
MARK       : HENDRIX    BLAIR      HAWKINS   
ANTONE     : ANITA      KERRY      COTTON     EVE       
JOHN       : KATY       LEONARDO   DECKER     DAMON     
MAXWELL    : LYMAN      TORRES     CURTIS    
ANNA       : ROBBY      ROBIN      LEONEL    
LETITIA    : HERRERA    LANA       FOREST     ORR        INGRID     BOB       
VALERIE    : RAMSEY     CRYSTAL    GRIFFIN    FLETCHER   CUNNINGHAM BERGER     GOODWIN   
MCKAY      : NORTON     CATHRYN    AURORA     RORY       LAURI      FERDINAND  BERNADINE 
PRINCE     : ADELINE    SUZETTE    REYNOLDS  
LUCIEN     : VELMA      ISIAH      KANE      
CHANEY     : OLIVER     AMIE       GIBSON     RAPHAEL    OTTO       JEANNE     KELLY     
GILMORE    : BARTLETT   WALTER     HOUSE     
LESLIE     : LESTER     STARK      TATE       TANIA      INA        ALI        FORREST    CONSTANCE 
LESLIE     : TANNER    
MARION     : RUTLEDGE   VIRGIE     BUCHANAN  
GLENN      : ANDY       DWIGHT     ROSALINDA  HUBBARD    HEWITT     JOYNER     BOWEN     
LEE        : REUBEN     POLLARD   
HATFIELD   : HIRAM      DUSTY      DANIEL    
CRYSTAL    : VALERIE    ARIEL      AYERS      ODOM       JARRED     WHITE      HOOD       ONEIL     
CRYSTAL    : ALFONSO   
LUCILLE    : GOMEZ      CHANCE     JOHNNIE    RUSSO     
PATE       : KLINE      REYNA      WATTS      LUCY       LAWANDA   
MONICA     : MILLIE     WENDY      FAITH      AIDA      
LENARD     : GUY        WALSH      JOSEPH     JILLIAN    ORTIZ     
RAMIRO     : KRISTOPHER LYNN       QUINTON   
PHOEBE     : NICHOLS    HULL       RASMUSSEN  DANA      
FOX        : HORTON     ROMERO     CONTRERAS  JIM        EVE       
ROBERTA    : JAMAAL     GRIFFIN    TREVINO    VICKI     
BENJAMIN   : PAGE       VELASQUEZ  ENRIQUE    MARCI      TAMMIE     LAWANDA   
LEONOR     : HUNTER     CHARLIE    CHANDLER   GEORGIA   
TILLMAN    : ISSAC      BURT       DIANE      BOYER      MARCELO   
AVIS       : HARRINGTON CHARLIE    MONTOYA    JEWELL    
ANDERSON   : CARLSON    KELLEY    
JENNINGS   : BOYD       AYERS      TIMMY      LACY       CARLA     
LATONYA    : CLAUDETTE  JASPER    
ODESSA     : HIRAM      OTIS       GARZA      JAMEL      LYNN      
LILIANA    : DONOVAN    DYLAN      KRYSTAL   
LITTLE     : EMILE      ANASTASIA 
MADELINE   : STEELE     HODGE      MANNING    LE        
PERCY      : ESTES      ANTONIO    SHANNON    JAY        LUCY       LLOYD     
WARD       : GABRIELA   TEDDY      RAUL      
KNOX       : LESTER     ALEXANDER  BOYD       GEORGIA    BRIGGS    
FIELDS     : BARRY      JULIA      DONNA      AUBREY    
AMIE       : CHANEY     GONZALO    LAUREL     SHELLEY   
WITT       : SYKES      STANLEY   
CANDICE    : CASTILLO   ELISEO     ERICKA     CLAUDIA   
MONTGOMERY : HERSCHEL   CASTRO    
JANELLE    : GARRETT    AMELIA     DANIELLE   CROSS      CONTRERAS  KEVIN     
HOLDEN     : POTTS      GERARDO   
DERICK     : NORA      
MEREDITH   : DAWN       PETER      CALVIN     ISIDRO     EVANGELINE
WALTERS    : LAUREL     RUSSELL    VALENTINE  BONNER     WALLER     KRISTINE   GIBBS      PARKS     
ABE        : OLGA       SWEET      CLARA      GRAHAM     ALINE     
JACKIE     : MICAH      JANICE     RUSSEL    
COPELAND   : HAROLD     NIELSEN    IRA        MAURICE   
ESTES      : PERCY      JULIO      PAYNE      HOLLAND   
HERRERA    : LETITIA    HENSON     LUCIANO    AVA        SHERMAN    RUSSEL    
THELMA     : OCTAVIO    BOB       
MILAGROS   : NEWMAN     FLORENCE   SHARON     JULIE      TORRES     SANTANA    JOAN      
ARIEL      : CRYSTAL    SONYA      LINDSAY    ROJAS      AUTUMN    
MERCADO    : JOHANNA    FARLEY     HENDRIX   
MCNEIL     : DARYL      RORY       ALYSON     LYNN      
SIMON      : IVANA      MARIBEL    MAE        WILKERSON  LON       
TODD       : DOROTHEA   CHANCE     KELLER    
MARCELINO  : RICE       ALVAREZ   
WILCOX     : TAYLOR     FLORENCE   JIMMIE     KAUFMAN   
LEACH      : CLAYTON    BOYER      RAY        BUCKLEY    RAYMOND    SHARRON    PARKS     
IRIS       : HARRELL    BUCK       TUCKER     MORRIS     AURORA     BENTON     STANTON    CROSBY    
INES       : HENDERSON  MUELLER    TERENCE    CLEMONS   
WEBSTER    : BRIANA    
RAMOS      : SCOTTIE    ROJAS      OLSEN      LAWSON    
BLACKWELL  : JACLYN     SCHULTZ   
ANIBAL     : EARL       EARLE      MORROW     LOTT       VAUGHN    
DONOVAN    : LILIANA    MAGGIE     DELMAR     STANTON    DAREN      SHERMAN   
LILA       : PARK       ARNULFO    LEMUEL    
HOBBS      : ARRON      JARROD     REFUGIO    MILO      
STACIE     : JULIA      DEANA      LUCAS      DEANNE     GRACIELA   CLARENCE  
CHRISTI    : GILBERT    TOBY       AMELIA     DARCY      INGRID     POOLE      PASQUALE  
LOIS       : HARRELL    DARNELL    JARVIS     DANIELS    SHAWN     
JAMAAL     : ROBERTA    BARRY      JOY        GIBSON     JOHNSON   
BALDWIN    : SEARS      HUBER      GRACIELA   FERDINAND  POOLE      RANDOLPH  
MONTY      : ART        VIRGIE     CONNER    
HARRINGTON : AVIS       JIMENEZ    STEFANIE   HUBER      PRUITT     MARIANO   
PICKETT    : OCONNOR    HEATH      CHANDLER   BARKER     SHEPARD   
EUGENIA    : VELMA      MCLEOD     RUTLEDGE   BRIANA    
SAM        : LESTER     HENDRIX    BRIDGET   
OCTAVIO    : THELMA    
HAMILTON   : ETTA       MICHEAL    FINLEY    
CRISTINA   : HULL       BOYER      WINFRED   
BRENDAN    : DEWAYNE    BERNADETTE COMPTON   
BARRY      : FIELDS     JAMAAL     HERBERT    GIOVANNI   LEMUEL     ROBERTSON 
WARREN     : TOBY       TAMERA     RICHMOND   LORENA     BARTON    
HANNAH     : CARSON     BALLARD    BONNER    
ERIN       : JAMAR      MORENO    
HOUSTON    : SHANA      VANCE      CASTRO    
BELL       : GOMEZ      GARRETT    ROOSEVELT  MAURICE   
SWEET      : ABE        BURT       BOWERS     NANETTE   
BARLOW     : MARCI      TOMMY      MICHAEL    SELLERS   
DUNN       : MILES      ROSEMARY   ERIK       SAVAGE     DANA      
LANA       : LETITIA    THOMAS     HOLCOMB    SANCHEZ    REINALDO  
YANG       : CHAVEZ     RONNY      HUNT      
ANDY       : GLENN      XAVIER     SERRANO    DALTON    
HIRAM      : HATFIELD   ODESSA     LULU       ZAMORA     DANIELS    ROBBINS    DELANEY    KASEY     
CONNIE     : BARNES     DAPHNE     TREVINO   
BARNES     : CONNIE     JACOBS     WALLER     BRYAN     
JEFFERSON  : FRY        KATHY      DYLAN     
PAMELA     : HUDSON     MCMAHON   
MERCEDES   : DARYL      KIDD       ANDREWS    WOODARD   
HORTON     : FOX        FOREST    
HERBERT    : BARRY      JODIE      KEVEN      SHAWN      IAN        HAWKINS    CARLA      FRANCISCO 
HERBERT    : CASSIE    
BARRERA    : JULIE      HEWITT     RUSSO     
MCCONNELL  : HARVEY     FRIEDA     BONITA     BOWERS     VERN       AURORA     SOLOMON    ROJAS     
ROSALIE    : JIMENEZ    BYRD       SAMUEL     LULU      
CHARLOTTE  : MOSES      BALLARD    HOLLIE     RAPHAEL    ROYCE     
JILL       : GREGORY    MERRITT    SANCHEZ   
MAC        : CANDY     
WALDO      : CUNNINGHAM CARVER    
LEVI       : EMORY      GILL       AURORA     MACDONALD  ALBERTO   
WARNER     : AVERY      JULIET     SUSIE      SALVATORE 
HARRELL    : IRIS       LOIS       WINTERS    BOOTH      EARLENE    PASQUALE  
GOMEZ      : LUCILLE    BELL       FLOSSIE    RODGERS    RITA      
SOTO       : MCINTYRE   MILO       MCBRIDE   
ABRAHAM    : OTIS      
JIMENEZ    : HARRINGTON ROSALIE    BARBER     MARSH      VARGAS     TANNER    
ALLISON    : LENORE    
BUCKNER    : HOLMAN     RUTLEDGE  
FREDERIC   : BALLARD    COOK       PAULETTE   CUMMINGS  
COMBS      : SIMONE     CALVIN    
DODSON     : ODELL      ALI        KRISTINE   CHARLENE  
REBEKAH    : FANNIE     ROSA       MARKS      LEMUEL    
ROSETTA    : TYREE      CECIL      JANICE     JEREMY     COLLINS   
HARDY      : CARISSA    AHMED      DWIGHT     LOTT      
VELASQUEZ  : BENJAMIN   CONSUELO   TONIA     
WEBER      : JOYCE      ERNESTINE  KENDRA     JOAN      
BAIRD      : BROCK      TAMMY      CHARLENE  
ALEXANDER  : KNOX       WEISS      HART       RITA       AVERY      YVETTE     DANIEL    
BRYON      : DOYLE     
MARGARITA  : RICE       PETTY      WILFORD   
OCONNOR    : PICKETT    SYBIL      DUNLAP    
ALVIN      : HOLMAN     FRANCESCA  ESTEBAN    CLAUDIA   
FOREST     : LETITIA    HORTON    
CHARITY    : BORIS      LORI       ROBBINS   
COOKE      : ELVIRA     GOODWIN    WILLIE     PARKS     
DIONNE     : DEJESUS    VICTORIA   OLSON     
TRICIA     : JOHNATHAN  PARRISH    GENARO    
VERA       : LANDON     FLORENCE   FAULKNER   ORTIZ     
NUNEZ      : LORRAINE   JERALD     BATTLE     BERNARDO   JOAN      
ALBA       : MCLAUGHLIN EARLENE    ROBERT    
ISSAC      : TILLMAN    LORRAINE   TREVINO   
FLOSSIE    : GOMEZ      EDMUND     ENGLAND    GRACE     
ELMA       : HENSON     JIM        TONIA     
BLEVINS    : WILLARD    WALSH      MARGERY    JESSICA   
BUCK       : IRIS       JULIO      HUBER     
NICOLE     : GUY        ZAMORA     CONNER     SHANNON   
MCMILLAN   : COLLIER    DAREN     
REEVES     : MEDINA     RICO       SHAWN      HOLT       ROSALINDA  TY        
BYRD       : ROSALIE    ROSEANN    ELINOR    
MOSES      : CHARLOTTE  BOWERS     LANCASTER 
IRWIN      : CHAVEZ     FRANCESCA  KEVEN      CLEMONS   
CAITLIN    : BURGESS    MCCALL     TREY      
STEPHENS   : EDMUND     AMANDA     THOMPSON   LUPE       MAXINE    
SYDNEY     : WALTON    
DINO       : ELOISE     SCOTTIE   
CLEMENTS   : LORIE      RENA      
MCCARTHY   : IGNACIO    GALEN      KRYSTAL   
OSCAR      : CHERRY     DEVON     
GRIFFIN    : RAMSEY     VALERIE    ROBERTA    BRADLEY    MERRITT   
LUNA       : CARNEY     REUBEN     CAMERON   
MCKEE      : KRISTOPHER MOLLIE     WILEY      CATHERINE  CAIN      
IVANA      : SIMON      MARA      
BAKER      : FEDERICO   BETHANY    ALEXANDRA  WINFRED   
DEENA      : GREGORY    HERMINIA   WALLER    
WINTERS    : KATHERINE  HARRELL    JORDAN     HUBER     
EMORY      : LEVI       MERLE      HOWELL    
ROBBIE     : ROXANNE    HERMINIA   ANNETTE    STACI      ROD        BRIDGET   
WEISS      : PEARSON    ALEXANDER  CONNER     LARSON     GOOD       EARNEST    AISHA     
LAUREN     : CAMACHO    ROBBINS    PAYNE     
ODELL      : MANN       DODSON     STRONG     PHELPS    
KNOWLES    : TABATHA    CRAFT      BRENTON    TERRELL    ESTELLA   
ROBBY      : ANNA       VIRGIE     PAYNE     
STUART     : DEJESUS    MARIBEL    BERTIE     JULIO      SELLERS   
OLA        : PAULETTE   KOCH      
GARTH      : SCHNEIDER  CRAFT      HEIDI      ROCKY      TINA       BENTON     ISIDRO     ALFONSO   
BEAN       : JANINE     NICHOLSON 
ANITA      : ANTONE     BORIS      LAWANDA   
VELMA      : LUCIEN     EUGENIA    BENTON     MADDEN    
KRISTIE    : MAVIS      THURMAN    SHANNON    FRANCISCO 
ARRON      : HOBBS      MASSEY     SUSIE     
JOHANNA    : MERCADO    BURGESS    HENDERSON 
BETTE      : VERN       TATE       CURRY      FRANKLIN  
ROBINSON   : NEWMAN     VERN       MCCORMICK  WILKINSON  WELLS      HOUSE      BULLOCK   
TABATHA    : KNOWLES    BRIGITTE   KARLA      JEANNE    
GRIMES     : FRY        BURTON     WELLS     
DARNELL    : LOIS       MCLEOD     MICAH      CHUCK      MORENO    
GILBERT    : CHRISTI    GARRY      OTIS       WATTS     
PITTS      : RAMSEY     BATTLE    
SANTIAGO   : LETICIA    MUELLER    ALICIA     MILDRED    EDWIN     
CLAYTON    : LEACH      MARGARITO  TERRY      REILLY    
GARRETT    : JANELLE    BELL       HOLDER     COTE       KRYSTAL   
MARIA      : BORIS      DONA       EVERETT    DELACRUZ   BUCHANAN   VAUGHN    
FISCHER    : CHAVEZ     WEAVER     LORNA      NELDA      JOHNSTON   ANGIE     
CARNEY     : LUNA       BRADLEY   
DILLON     : VALENCIA   ADAMS      OLSON      BERNARDO  
CASE       : BROCK      STOUT      DOMINGO   
PITTMAN    : REYNA      BOOTH      ARNULFO   
SCHNEIDER  : GARTH      DAPHNE     SUAREZ     SHARRON    VAUGHN    
WYATT      : CLAY       MEADOWS   
MCLEOD     : EUGENIA    DARNELL    MARIE      FRANCESCA  MARTHA     DANIAL    
MCLAUGHLIN : ALBA       DOYLE      PACHECO    CAROLINE   TAMMIE     MICHAEL    TRUDY     
WELCH      : ROXANNE    LATISHA    TOMMY      MOODY      BRIDGET    STANLEY   
MCKENZIE   : MILLER     KARYN     
HART       : ALEXANDER  SARGENT   
SPENCE     : JIM        MCCARTY    CLEMONS   
PENNINGTON : CHANG      MALDONADO  SHAWN      VINCENT    STEWART   
JOHNS      : HUNTER     DEANDRE    MARIE      KENDALL    GLASS      WENDY      DAMON     
HANSON     : CONLEY     BARR      
NOLAN      : FEDERICO   KERRI      BRYANT    
DEJESUS    : DIONNE     STUART     WISE       DUKE       EVAN      
BURT       : TILLMAN    SWEET      STRICKLAND ROBERT    
HUNTER     : HOOPER     LEONOR     JOHNS      KATHARINE  GENEVA     LLOYD     
MICAH      : JACKIE     DARNELL    SHANA      PRUITT     DELANEY   
FANNIE     : REBEKAH    FREEMAN    ANASTASIA  OWEN      
CORY       : NANNIE     VEGA      
REYES      : ANDREA     NORRIS     PHILLIP   
URSULA     : CHERI      RICK       ROWE      
JARVIS     : LOIS       FOWLER     PUGH       DUNCAN    
JUSTINE    : SLOAN      SERRANO    JOSE      
MARIBEL    : SIMON      STUART     REINALDO  
RODNEY     : CASTILLO   TOBY       SHANA      GABRIELA  
HEBERT     : BURGESS    WILL       TIMOTHY    LORENZO   
SILVA      : LEWIS      THURMAN    GOODWIN    OWEN      
JACLYN     : BLACKWELL  LINDA      DELMAR     COX        KENDRA     EVANGELINE TONIA     
PHILLIPS   : TRACEY     KLINE      NANCY      HAWKINS    CAROLE    
TOBY       : CHRISTI    WARREN     RODNEY     MIKE       VIRGIE     PRISCILLA  DALTON    
GONZALEZ   : RUSS       PAYNE      DONALD     HARMON     PATRICK   
ELLIS      : TREY       MCCRAY     PATRICK    PARKS     
CHARLIE    : LEONOR     AVIS       ALVAREZ    COMPTON    FLYNN     
HOLMAN     : BUCKNER    ALVIN      DAPHNE     GRACIELA   FREDERICK 
EDMUND     : FLOSSIE    STEPHENS   TYREE      MARCELO    MILLS     
FRY        : JEFFERSON  GRIMES     MYRA       LAURI      BATTLE     MITCHELL  
CARSON     : HANNAH     WASHINGTON
HUGHES     : WOLFE      EDWIN      MCBRIDE   
BURGESS    : CAITLIN    JOHANNA    HEBERT     TAYLOR     BEACH      MICHEAL    ROSARIO    COLEMAN   
AUSTIN     : ABEL       BILLIE     LACEY     
PIERCE     : PHILIP     HERSCHEL   GOODWIN    FRANCISCO 
DENIS      : HILARIO    NICHOLS    KELLER    
CHANG      : PENNINGTON FLORES     DOYLE      GRACIELA   ARNULFO    LEON      
HINES      : WILFREDO   CANTU      HUDSON     KRYSTAL   
TRACEY     : PHILLIPS   PRUITT     DANIAL     JOYNER    
DARYL      : MCNEIL     MERCEDES   ABEL       GUTHRIE   
DIAZ       : DELBERT   
CECELIA    : WALTON     BENTON     ALFRED     WHITNEY   
LARSEN     : POOLE     
RICE       : MARCELINO  MARGARITA  ROMERO     JANINE     ADELINE    MARVIN    
BRIAN      : RICHARD    CHANDLER   TINA       ELBERT    
JOHNATHAN  : TRICIA     ISRAEL     DALE       FLYNN     
BENNIE     : CARMELO   
ERICK      : MCCALL     ASHLEY     NIEVES     ELIJAH    
LEANNE     : BOYER      NANETTE    PRESTON    ELBERT     PATSY     
KENT       : GREGORY    SYKES      AIDA      
COOLEY     : ROSE       PACHECO    HAZEL      COLEMAN    JILLIAN    MARCIA     ESTRADA    TONIA     
TASHA      : JOHNNIE   
BERT       : ROY        MARA      
GUY        : LENARD     NICOLE     DUNCAN    
CLARK      : WALSH      BLAKE      ANNABELLE 
TUCKER     : IRIS       CAMACHO    KIDD       COX        JOYNER     BRIGGS    
VONDA      : LYDIA      JOSUE     
FROST      : MARTHA     MARGARITO  SAMPSON    FAITH      KRISTINE  
NORTON     : LESTER     MCKAY      ROY        JULIO     
CRAFT      : KNOWLES    GARTH      DOYLE      HENDRIX    OBRIEN    
LYDIA      : VONDA      LAMBERT    WOLFE      DARCY      DOMINGO    JUAREZ     HOOD       KANE      
FRYE       : SHIRLEY    TRAN       ROBERTSON 
SELENA     : TARA       ART        RITA       MITCHELL  
BRIDGETTE  : WILLIS     GERARDO    LEONEL     STANTON   
WOLF       : GIOVANNI   HUGH       CARMELO    FORREST    ADDIE      WONG       ANNABELLE 
THOMAS     : LANA       LYMAN      PRUITT     GARNER     BILLIE     ALBERTO    DON       
YOUNG      : WILLARD    BERTIE     FIGUEROA   TERRY     
DEANDRE    : JOHNS      PAM        MOODY     
KIM        : RICK       JAY       
ENGLAND    : FLOSSIE    BARKER    
CHELSEA    : DOROTHEA   TERRY      HOMER     
AGNES      : BRANDY     HOLDER    
SILAS      : PETTY      ALFREDA    VEGA       SIMONE     MERLE      TYLER      TRACY     
MAGGIE     : DONOVAN    MCCULLOUGH WILFREDO   FREEMAN    RANDOLPH  
HIGGINS    : STEVENS    GRAY       SHERMAN    LORNA     
TYREE      : ROSETTA    EDMUND     EVANGELINA MARCY     
ELOISE     : DINO       MARIANA    JOSEPHINE 
TOM        : BOBBI      CURTIS    
MARGUERITE : LANDON     ETTA       CALLAHAN  
DEWAYNE    : BRENDAN    HOUSE      COLLINS   
FLOYD      : KATHY      HURST      MAXINE     CONSTANCE 
RICHARD    : BRIAN      BOB        MASSEY     MENDOZA    ALEXANDRA  HOWELL    
EDITH      : STANLEY   
WHITAKER   : XAVIER     LANCASTER  POOLE      REILLY    
ANNIE      : FRANCES    ELVA      
FLETCHER   : VALERIE    CAROLYN    CATHERINE  EARLENE    CORTEZ     BRIGGS    
CHRISTA    : LEWIS      REUBEN     FRANCES    HERIBERTO 
LEONARDO   : JOHN       SHEPARD    JESSE      JARED     
LANGLEY    : RASMUSSEN  WALL      
STEFANIE   : HARRINGTON MEDINA     LOTTIE     NORRIS    
STEELE     : MADELINE   WEAVER     ALICIA     ELIJAH     ROMAN      RUSSEL    
BARTLETT   : GILMORE    BOB        MARIANA    DEVON     
KLINE      : PATE       PHILLIPS   AHMED      GUZMAN     BERNARDO  
KRISTOPHER : RAMIRO     MCKEE     
ETTA       : HAMILTON   MARGUERITE SOLIS      LEVINE     TIMMY      ROSALES   
ISABELLE   : DELANEY    ELLIOTT    HOWARD    
AMELIA     : JANELLE    CHRISTI    TARA       WALSH      LORENZO    FRANKLIN  
TARA       : SELENA     AMELIA     PARRISH    MENDOZA    CARVER     HELGA     
ALTON      : HURLEY     LINDA      MERLE     
BALLARD    : HANNAH     CHARLOTTE  FREDERIC   DAMIAN    
ROMERO     : FOX        RICE       BONITA     MCFADDEN   ALFONZO    NGUYEN    
RIVERA     : BUDDY      BIRD      
JOY        : JAMAAL     GALEN      BARBER     SARGENT    GALLOWAY  
ALTA       : DANIELLE   AVERY      JARRED     MERRITT   
MARIE      : MCLEOD     JOHNS      CONCEPCION
MCCULLOUGH : MAGGIE     BEST       SCOTT      AIDA      
SEARS      : BALDWIN    FERN       VANCE     
NEWMAN     : MILAGROS   ROBINSON   FEDERICO   DELMAR     BEASLEY   
JODIE      : HERBERT    FRANCIS   
JAIME      : DAPHNE     SUZETTE    TRACY     
BROCK      : BAIRD      CASE       ELIZA      CONRAD     FORREST    SANCHEZ   
SLOAN      : JUSTINE    CANTRELL   VIRGIE     VALENTINE  NORMA     
NICOLAS    : GLADYS     BOB        CASEY      HOLLAND   
HENSON     : HERRERA    ELMA       LUCAS      CHRISTIAN  PATSY     
CLAUDETTE  : LATONYA    SARGENT    AMADO     
MILLICENT  : ROBBINS    MACK       LORAINE   
RIOS       : JUANITA    MARCEL     WINFRED   
XAVIER     : ANDY       WHITAKER   LES        PAYNE      ROD        HARRIET   
CONLEY     : HANSON     CLEVELAND  BARBER     MCINTYRE   TOWNSEND  
ROSE       : COOLEY     LETICIA    NAPOLEON   HECTOR     BARR       GIBBS      KANE      
MARYANNE   : PAULETTE  
DAVIS      : GILL       KERI       NORRIS    
POTTS      : HOLDEN     DELANEY    DELORIS   
MEDINA     : REEVES     STEFANIE   MURIEL     VINCENT    DUNCAN    
WIGGINS    : LATISHA    BRUCE      SCHWARTZ   MITCHELL   EVANGELINE
BRANDY     : AGNES      BERGER     CAMERON    MELBA      HOLLAND   
BERTIE     : STUART     YOUNG      FRANKS     QUINCY    
BRIGHT     : LORIE      GLASS      CRAIG     
FRANKS     : MANN       BERTIE     KATHARINE  DALTON     MADDEN    
FORBES     : WHITFIELD  ELINOR    
MARY       : FRIEDA     DOYLE      DARCY      KIP       
CARLENE    : COLLIER    DEANNE    
HARVEY     : MCCONNELL  PACHECO   
MILLER     : MCKENZIE   DUSTY      BRIANA     HERSCHEL   SHARRON   
DARRELL    : MILDRED    MAXINE     MICHAEL    ROYCE     
FEDERICO   : BAKER      NOLAN      NEWMAN     AURORA    
LEWIS      : SILVA      CHRISTA    ANA       
CECIL      : ROSETTA    COMPTON   
RICO       : REEVES     BOYER      SONYA      VINCENT    LANCASTER  ALISSA     FERRELL   
LUCIANO    : HERRERA    SHEPHERD   CANTU      CASSIE    
FRIEDA     : MCCONNELL  MARY       SIDNEY     MERLE      ELINOR    
PETTY      : MARGARITA  SILAS      WOODWARD   LENORE     JOSUE      ROBERTSON 
TAYLOR     : WILCOX     BURGESS    ISABELLA  
ERIKA      : RONALD     LUCAS      CONTRERAS  MCCARTY   
WILFREDO   : HINES      MAGGIE     CHAN       MYERS      NAVARRO    ANGIE     
STRICKLAND : BURT       BOYER      SIMS      
CASANDRA   : HENDRIX    CRANE      ALI        MONA       LORAINE   
FREDDIE    : ESMERALDA  LORENA     GRAY       TAMMIE     HUMBERTO   DEAN      
ISRAEL     : JOHNATHAN  LAUREL     HERIBERTO  CHERRY    
AMANDA     : STEPHENS   BERGER     ADAMS      BURRIS     WALL       MAYNARD    SHELLEY   
MOLLIE     : MCKEE      ROSS       JESSIE     TURNER     ALINE     
GILL       : LEVI       DAVIS      BARBER     JARED     
BONITA     : MCCONNELL  ROMERO    
GARRY      : GILBERT    HOLCOMB    WISE       DAVENPORT  DARIN     
JORDAN     : KATY       WINTERS    MERLIN     WELLS      CLAUDIA   
KATHY      : JEFFERSON  FLOYD      BOBBIE     HENDERSON  ORTIZ      GATES     
DAPHNE     : CONNIE     SCHNEIDER  HOLMAN     JAIME      KEVEN      KELLEY     NEIL       WALL      
DAPHNE     : CEDRIC    
WALSH      : LENARD     BLEVINS    CLARK      AMELIA     FULTON     RUSS       MUELLER    BENITO    
ANDREA     : REYES      SHARON     ELVA       PATRICK    TORRES    
TAMERA     : MANN       WARREN     NOELLE     CARROLL    MERRILL   
NOE        : BUTLER     GOLDIE    
GIOVANNI   : BARRY      WOLF       JARED     
WILL       : HEBERT     RONALD     FOSTER     GRACE      MAYER     
JOYCE      : WEBER      CHAN       ANGIE      DARRYL    
WHITLEY    : ROBLES     CONRAD     BLAKE     
WEEKS      : ANTONIA    BRADSHAW   LARSON     LEONARD    DAMON      HUNT       MERRILL   
HILARIO    : DENIS      COLLIER    SERRANO    DANIAL     KRAMER    
CHAN       : WILFREDO   JOYCE      NEAL       FARLEY    
BEST       : MCCULLOUGH TAMMY     
FLORES     : CHANG      FIGUEROA   HENSLEY    JARRED    
JOANNA     : SALAZAR    TERRELL    COTE       KERR      
DONNY      : PEARSON    RICHMOND  
BRADLY     : OLGA       DOYLE      HAROLD     JACKSON    REGINA    
BUTLER     : NOE        BOLTON     HOLLAND   
VASQUEZ    : MCDONALD   RODRIQUEZ  PUCKETT    ELBERT    
NICHOLS    : PHOEBE     DENIS      DECKER     RICK      
KERRY      : ANTONE     SCOTT      RICHMOND   BUCHANAN   DEANNE     WONG      
BORIS      : CHARITY    ANITA      MARIA      SUSANNA   
VICKY      : MARTHA    
COOK       : FREDERIC   HORN       CLEVELAND  FREEMAN    LARSON     HERMAN    
ROY        : BERT       NORTON     FIGUEROA   CHERI      ETHEL     
BOWERS     : SWEET      MCCONNELL  MOSES      RENA      
HEATH      : PICKETT    PEREZ      VALENZUELA CHARMAINE 
STOUT      : CASE       ROSEMARY  
CLYDE      : JERALD    
DANIELLE   : JANELLE    ALTA       JAYNE      JAMAR      LACEY      TRAVIS    
PHILIP     : PIERCE     HUGH       MYRA       ANA        AUGUSTINE  TRENT     
HANEY      : BOBBIE     TAMMI      WENDY     
RUTLEDGE   : MARION     EUGENIA    BUCKNER    TOWNSEND   GILES      VARGAS     MCCLURE   
DONA       : MARIA      MADDEN     REILLY    
LOURDES    : STARK      FULTON     CARROLL    JAMAR     
MCFADDEN   : ROMERO     CONCEPCION LLOYD      BETH      
TIMOTHY    : HEBERT     ERNESTINE  JUANITA    NORMA     
DIANE      : TILLMAN    BOBBI      FUENTES   
NEAL       : CHAN       CRAIG     
KATHARINE  : HUNTER     FRANKS     CARMINE    LINDA      ERNIE      TYLER      NGUYEN    
KRISTINA   : PATRICK    CHRISTINE  ALI        JOHNSON   
BOBBIE     : KATHY      HANEY      BRIANA     GILES     
MANUEL     : DIXIE     
ANNMARIE   : JARED      POOLE      ELINOR    
SCOTT      : MCCULLOUGH KERRY      GONZALO   
PECK       : CARLSON    ROCKY      GABRIELA   MABEL      HALL      
CANTRELL   : SLOAN      ROBLES     ALFONZO    CAROLINE   MCCRAY     GOOD       ISIDRO    
JULIO      : ESTES      BUCK       STUART     NORTON     COMPTON    FINLEY     RACHAEL   
ABEL       : AUSTIN     DARYL      RICARDO    PUGH      
ROCCO      : MERLIN     SERRANO    MOODY      ALEXANDRA  ANNABELLE 
FIGUEROA   : YOUNG      FLORES     ROY        BERGER     YVETTE     ALBERT    
JULIA      : FIELDS     STACIE     CALDWELL  
HENSLEY    : FLORES     CARMELO    ROMAN     
ROXANNE    : MANN       ROBBIE     WELCH      FARLEY     RICHARDSON
BURTON     : GRIMES     AL         CONNER     TRAN       MOODY      TONIA     
GLADYS     : NICOLAS    BRADSHAW   PAYNE      DEWITT    
SIDNEY     : FRIEDA     CATHERINE 
WOODWARD   : PETTY      HAYS       EARLENE    MILDRED    NANCY      MCLEAN     GALLOWAY  
LAMBERT    : WILLARD    LYDIA      FOWLER     LORNA      JOYNER    
DEANA      : STACIE     MUELLER    NORMA     
CAROLYN    : OLGA       FLETCHER   JANINE     HOUSE     
CUNNINGHAM : VALERIE    WALDO      DAWN      
SARA       : PEARSON    DONNA      JOAN      
KERI       : DAVIS      BETHANY    RICHARDSON BARBRA    
GONZALO    : AMIE       SCOTT      IGNACIO    REYNA      DELACRUZ  
DOYLE      : BRYON      MCLAUGHLIN CHANG      CRAFT      MARY       BRADLY     BUDDY      NOEL      
ADAM       : ALEXANDRA  SAVAGE    
IGNACIO    : MCCARTHY   GONZALO    LORIE      FOSTER     ERMA       MCMAHON   
GREGORY    : JILL       DEENA      KENT       RODRIGUEZ  PHILLIP   
WOLFE      : HUGHES     LYDIA      JOSEPH     DYLAN      CAROL      CASTRO     CORRINE   
MILES      : DUNN       FOWLER     ELIJAH     MACDONALD  COLLINS   
HORN       : VILMA      COOK       ELBERT    
MORRIS     : IRIS       SANDOVAL   AHMED      ERMA      
STARK      : LESLIE     LOURDES    BRIGITTE   ERICKA     JESSE      BURKS     
LORENZO    : HEBERT     AMELIA     NOELLE     RYAN       FORREST    ELINOR     MCCLURE   
KENNEDY    : KARYN      FORREST   
ROBLES     : WHITLEY    CANTRELL   KURT       LELIA      TANIA      HUNT      
LEBLANC    : JEREMY     GALLOWAY  
REUBEN     : LEE        LUNA       CHRISTA    TERRI     
LYMAN      : MAXWELL    THOMAS     FULLER     KRISTEN   
DALE       : JOHNATHAN 
DARCY      : RAMSEY     CHRISTI    LYDIA      MARY       JANETTE   
SERGIO     : ERNESTINE  FOSTER    
DONNA      : FIELDS     SARA       JUANITA    MITCHELL   CORRINE   
ENRIQUE    : BENJAMIN   VINCENT    LOWE       JIM        MCLEAN    
SHERYL     : HURST      ONEIL     
MARTINEZ   : AUBREY     JEAN      
ART        : MONTY      SELENA     CARR       ISIAH      MCCARTY   
LOTTIE     : STEFANIE   NORMA      FREDERICK  NATASHA   
CHERI      : URSULA     ROY        PAULETTE   BOLTON     FRANCIS    COTE      
COLLIER    : MCMILLAN   CARLENE    HILARIO    SCHULTZ    GILES      LEMUEL    
HINTON     : FAULKNER   MCCRAY     WATERS     GUZMAN     PARSONS   
HUBER      : BALDWIN    HARRINGTON BUCK       WINTERS    NANETTE   
MIKE       : TOBY       THOMPSON   MARCUS     HENRIETTA  LOWE      
RONALD     : ERIKA      WILL       JOAN       BERNADINE 
MCCALL     : CAITLIN    ERICK      TONI      
ALFREDA    : SILAS      SALAZAR    RICHMOND   ADELINE   
KARYN      : MCKENZIE   KENNEDY    BRIGITTE   TRUDY      PARKS     
THOMPSON   : STEPHENS   MIKE       NIGEL      FRANCIS    BONNER     DUNCAN     RENA      
HURLEY     : ALTON      MONTOYA    RONNY      REYNOLDS  
HULL       : PHOEBE     CRISTINA   AL         EVAN       SELLERS   
MARCI      : BENJAMIN   BARLOW     CHANDLER   VINCENT    VIRGIE    
TAMMI      : HANEY      JANICE     DURAN      HAYDEN    
ELISEO     : CANDICE    HERMINIA   ELVIRA     ONEIL     
CAMACHO    : LAUREN     TUCKER    
LENORE     : ALLISON    PETTY      AVERY      BRUNO      WALL      
BOYD       : JENNINGS   KNOX       FOWLER     FRANCISCO 
HEIDI      : ROB        GARTH      HUBBARD   
CARISSA    : HARDY      AHMED      TERENCE    JOHNNIE   
MALDONADO  : PENNINGTON LETICIA    YVETTE     LON        LACEY      ANGELITA   MCGOWAN   
CARMINE    : KATHARINE 
PAULETTE   : FREDERIC   OLA        MARYANNE   CHERI      CLARA      ANDREWS    GIBBS     
HOPKINS    : WILBUR     SOLOMON    HOOD      
MARYELLEN  : DELMAR     TANIA     
MOSS       : SUAREZ     WISE       PAYNE      DONALD    
CHANDLER   : LEONOR     PICKETT    BRIAN      MARCI      SUSAN      LAURI     
GRETA      : MCDONALD   CARROLL    AYALA     
LORRAINE   : NUNEZ      ISSAC      AVERY      WATTS      VAN        JACKSON   
RASMUSSEN  : PHOEBE     LANGLEY    EDGARDO    HENRY     
CROSS      : JANELLE    AVERY      ERMA       MARCY      MITCHELL  
AYERS      : CRYSTAL    JENNINGS   SANDOVAL   FULTON    
BEACH      : BURGESS    GABRIELA   CRANE      HENRY      RUSSO     
ODOM       : CRYSTAL    EARLE      TANIA     
KENDALL    : JOHNS      STEVENS    MONTOYA    TERENCE    JOHNSON   
PAM        : DEANDRE    LEANN      NEIL       KEITH      BRYANT    
VICTORIA   : DIONNE     WATERS     THADDEUS  
DENA       : LUCAS      SYBIL      JEANNE    
LANE       : FRANCIS    BRADFORD   ADDIE      HARRIS    
SUAREZ     : SCHNEIDER  MOSS      
MARA       : IVANA      BERT       LANCASTER  SCOTTIE    CHRISTIAN  INGRAM     ALINE     
CLAY       : WYATT      MABEL     
HOLLIE     : CHARLOTTE  JOHNSTON  
CHAVEZ     : YANG       IRWIN      FISCHER    JEANNE     BARBRA    
LES        : XAVIER     GINGER     CALDWELL   COTE      
THURMAN    : KRISTIE    SILVA      BOOTH      CONTRERAS  JEWELL     BARTON    
HUGH       : WOLF       PHILIP    
SCHULTZ    : BLACKWELL  COLLIER    PATEL      ANDREWS    TRENT     
SAMUEL     : ROSALIE    MAYER      CUMMINGS  
FRANCESCA  : ALVIN      IRWIN      MCLEOD     FULLER     FINLEY    
HOLCOMB    : LANA       GARRY      FULLER     BILLIE     MACK      
SHANA      : HOUSTON    MICAH      RODNEY     FERDINAND 
BUDDY      : OLGA       RIVERA     DOYLE      DELBERT    ROBERTSON 
NIGEL      : OLIVER     THOMPSON   JEANNE    
MILLIE     : MONICA     SWANSON    MILLS     
RICHARDS   : SCHROEDER 
BERGER     : VALERIE    BRANDY     AMANDA     FIGUEROA   GLASS      NOEMI      JOHNSTON  
BURCH      : PARSONS   
SOLIS      : VILMA      ETTA       DUSTY      LACY      
FARLEY     : MERCADO    CHAN       ROXANNE    KATHLEEN   VAUGHN    
DOMINGO    : CASE       LYDIA      BATTLE     JULIAN    
DOROTHEA   : TODD       CHELSEA    EVERETT    ROBIN     
ELIZA      : BROCK      BOWMAN     RICHARDSON TANYA     
RODRIGUEZ  : KATHERINE  GREGORY    BOLTON     GALLOWAY  
JOSEPH     : MARISOL    LENARD     WOLFE      CONCEPCION ANDREW    
GALEN      : MCCARTHY   JOY        WALL       HELGA     
MOLINA     : STANTON    ALI        STEPHENSON NICHOLSON  KERR      
RICARDO    : ABEL       SAMPSON    INGRAM    
CARMELO    : BENNIE     WOLF       HENSLEY    NOELLE     AVA       
RODGERS    : KATY       GOMEZ     
ORR        : LETITIA    DUKE      
DAWN       : MEREDITH   CUNNINGHAM COX        TANYA      MACK      
PETER      : MEREDITH   JERALD     JUANITA   
LULU       : HIRAM      ROSALIE    SHARRON    NELDA     
TREY       : CAITLIN    ELLIS      ED         WASHINGTON MAYNARD   
HENDRIX    : MARK       MERCADO    SAM        CRAFT      CASANDRA  
SUSAN      : CHANDLER   MILDRED    CAIN       RENA      
LUPE       : STEPHENS   SANDOVAL   LAURI     
JONI       : JULIET    
HERMINIA   : DEENA      ROBBIE     ELISEO     OTIS       ERMA       SANCHEZ    PALMER     TRENT     
EVERETT    : MARIA      DOROTHEA   EMILE      HOMER     
WEAVER     : FISCHER    STEELE     MERCER     GILES      SHARRON    ANDREW    
NETTIE     : ENGLISH    ELDON      BERNARDO   TRAVIS    
WILLIS     : BRIDGETTE  NEWTON     ELDON      LIDIA     
VERN       : MCCONNELL  BETTE      ROBINSON   CLARENCE  
RITA       : GOMEZ      ALEXANDER  SELENA    
EMILE      : LITTLE     EVERETT    DIXON     
FERNANDEZ  : BOYER      LEONARD   
ALVAREZ    : MARCELINO  CHARLIE   
ED         : TREY       KEVEN      ANTHONY    DICK       VANCE      LEON      
BOYER      : TILLMAN    LEACH      CRISTINA   LEANNE     RICO       STRICKLAND FERNANDEZ  ROBT      
BOYER      : STEVENS   
FLORINE    : ROCKY      TINA      
FOWLER     : JARVIS     LAMBERT    MILES      BOYD       BRADSHAW   PATSY      MACK      
LATISHA    : WELCH      WIGGINS    KIP       
LETICIA    : SANTIAGO   ROSE       MALDONADO  DAVID      DARIN      NAVARRO    ROD        MARCIA    
LETICIA    : FRANKLIN  
CARLO      : ANASTASIA  ROYCE     
CONRAD     : BROCK      WHITLEY    CORRINE   
ELVIRA     : COOKE      ELISEO     MAE        MCCRAY     KNIGHT    
MERLIN     : JORDAN     ROCCO      OLSON     
KOCH       : OLA        PAYNE      DELGADO    ARTHUR    
PARK       : LILA       LUISA      AUTUMN     KASEY     
KEVEN      : HERBERT    IRWIN      DAPHNE     ED         MATHIS     HARRISON  
ARMSTRONG  : MYRA       EVAN       ANDREW    
KURT       : LANDON     ROBLES     MARCUS     LELIA      SOFIA      BRIDGET   
ZAMORA     : HIRAM      NICOLE     DUSTY      NORA       CALVIN    
SEBASTIAN  : GRACIELA  
AL         : BURTON     HULL       ELBERT    
MARCUS     : MIKE       KURT       TERRI      ROSARIO   
MICHEAL    : HAMILTON   BURGESS    SOLOMON    CLINT     
BLANCHARD  : TERRI      PRESTON    ANTONIO   
TREVINO    : ROBERTA    CONNIE     ISSAC     
DUSTY      : HATFIELD   MILLER     SOLIS      ZAMORA     MATTHEWS   AIDA      
BRIGITTE   : TABATHA    STARK      KARYN      BARBER     ESTEBAN   
ROSS       : MOLLIE     STACI      RICK       TERRENCE   KRYSTAL   
SONYA      : ARIEL      RICO       LINDSAY    LACY       LIDIA      JOYNER    
LELIA      : ROBLES     KURT       TRAN       RENA      
ROSEANN    : BYRD      
OTIS       : ODESSA     ABRAHAM    GILBERT    HERMINIA   BENTLEY   
NORRIS     : REYES      STEFANIE   DAVIS      SHERRI    
SALAZAR    : JOANNA     ALFREDA   
MAE        : SIMON      ELVIRA     GINGER     RICKY      ADDIE     
WILEY      : MCKEE      SHEPHERD  
LEVINE     : ETTA       BENTLEY    VAUGHN    
NITA       : JASPER     IRVIN      RAPHAEL   
CATHERINE  : MCKEE      FLETCHER   SIDNEY     CROSBY    
BARKER     : PICKETT    ENGLAND    LORIE      TINA       MOSLEY     DARRYL    
JESSIE     : MOLLIE     MCCRAY    
PATEL      : SCHULTZ    GIBSON     JOSE       STRONG    
LORI       : CHARITY    KARLA     
TERRI      : REUBEN     MARCUS     BLANCHARD  NANNIE    
MAYS       : ANDREW    
FOREMAN    : MARGARITO  KENDRA    
ROCKY      : GARTH      PECK       FLORINE    AUGUSTINE  ALICIA     CASSIE    
GERARDO    : HOLDEN     BRIDGETTE  REYNA      MUELLER    SONNY      FRANKIE    LEROY      MARTIN    
FRANCES    : ANNIE      CHRISTA    ANASTASIA 
EDGARDO    : RASMUSSEN  JARED     
PORTER     : JIMMIE     GUZMAN     ROSALES    MINNIE    
NANETTE    : SWEET      LEANNE     HUBER      SCOTTIE    REILLY    
PACHECO    : MCLAUGHLIN COOLEY     HARVEY     HARMON     MINNIE    
KATHLEEN   : FARLEY     KERRI      KEVIN     
SHIRLEY    : FRYE       LINDA     
AURELIA    : STRONG     SHERRI    
POPE       : HARRISON   EARNEST    FRANCISCO 
VICTOR     : NEIL       RORY       RAPHAEL   
DANIELS    : LOIS       HIRAM      CAROLINE   HOWELL    
MARTHA     : MCLEOD     FROST      VICKY     
BRIANA     : KATHERINE  WEBSTER    EUGENIA    MILLER     BOBBIE     ERMA      
REYNA      : PATE       PITTMAN    GONZALO    GERARDO    KASEY     
QUINCY     : BERTIE     VALENTINE 
HOLDER     : GARRETT    AGNES      ALEXANDRA  WENDI     
NAPOLEON   : ROSE       AHMED      COTTON     GONZALES   CUMMINGS  
GABRIELA   : WARD       RODNEY     PECK       BEACH      HICKS      HOWARD    
BETHANY    : BAKER      KERI      
SHEPARD    : PICKETT    LEONARDO   BOBBI      GIBBS      CONSTANCE 
LAUREL     : AMIE       WALTERS    ISRAEL     BRANDI    
FLORENCE   : MILAGROS   WILCOX     VERA       EVANGELINA
ROSA       : REBEKAH    HECTOR     GILBERTO  
HAROLD     : COPELAND   BRADLY     HOGAN     
SANDOVAL   : MORRIS     AYERS      LUPE       BERNARDO  
HENRIETTA  : MIKE       ROBIN      BRUNO      JOHNSON    BRIGGS    
WHITFIELD  : FORBES     CONSUELO   DUFFY      STANLEY    REGINA    
CLARA      : ABE        PAULETTE   ANTHONY    IRA        TONIA     
FULTON     : WALSH      LOURDES    AYERS      DIXIE     
ROBIN      : ANNA       DOROTHEA   HENRIETTA  STANLEY   
WALTER     : GILMORE   
JANINE     : BEAN       RICE       CAROLYN    COLLIN     KENTON     LE        
BENTLEY    : OTIS       LEVINE     TOMMY      JOYNER    
JASPER     : LATONYA    NITA       FULLER     COFFEY    
ERNESTINE  : WEBER      TIMOTHY    SERGIO     NEWTON     TAMMIE     TONI       BILLIE    
GARZA      : ODESSA    
EVANGELINA : TYREE      FLORENCE   MATHIS     JOYNER    
SHAWN      : LOIS       HERBERT    REEVES     PENNINGTON MARGERY   
INGRID     : LETITIA    CHRISTI    WILBUR     DORA       CLINT     
LINDA      : JACLYN     ALTON      KATHARINE  SHIRLEY    GEORGE     DIXIE     
SIMS       : STRICKLAND GRACE     
MURIEL     : MEDINA    
ANNETTE    : ROBBIE     HOMER      BURRIS     BENITO     ODONNELL  
LORIE      : CLEMENTS   BRIGHT     IGNACIO    BARKER     NANNIE     NANCY      SCHROEDER 
MYRA       : FRY        PHILIP     ARMSTRONG  BARR      
GLASS      : JOHNS      BRIGHT     BERGER     KELLY     
LINDSAY    : ARIEL      SONYA      HENDRICKS  RODERICK  
ROBT       : BOYER      NIEVES     FULLER     OTTO      
PRUITT     : HARRINGTON MICAH      TRACEY     THOMAS     STEWART    MATHIS     DELBERT   
FOSTER     : WILL       IGNACIO    SERGIO     FERN       DENNIS     NORMA     
VINCENT    : PENNINGTON MEDINA     RICO       ENRIQUE    MARCI      CHANCE    
NOELLE     : TAMERA     LORENZO    CARMELO    EARL       CHERRY     KNIGHT     LEROY     
GOODMAN    : RAMSEY     JERALD     JANETTE    RAY        WELDON    
RYAN       : LORENZO    EMILY      CORTEZ     TANYA     
RICHMOND   : WARREN     DONNY      KERRY      ALFREDA   
LUCAS      : STACIE     HENSON     ERIKA      DENA      
DYER       : JOSUE      SHANNON    CAIN       RANDOLPH   PARSONS   
RUSSELL    : PERRY      WALTERS    SHARRON    ETHEL     
BOB        : LETITIA    THELMA     RICHARD    BARTLETT   NICOLAS    JERALD     MONROE    
MARIANA    : ELOISE     BARTLETT   TOWNSEND   MOODY      SAVAGE    
CRANE      : CASANDRA   BEACH      SUZETTE    ANDREWS    COMPTON    NAVARRO    HOWARD    
ADELINE    : PRINCE     RICE       ALFREDA    WOODARD   
GINGER     : LES        MAE        MOHAMED    ERNA       KERRI     
NANNIE     : CORY       TERRI      LORIE      HAYS       DEANNE    
MALLORY    : HEWITT    
REESE      : ROYCE      GRAHAM     JULIAN    
WILBUR     : HOPKINS    INGRID     AUTUMN     SIMPSON    SANCHEZ   
CLEVELAND  : CONLEY     COOK       HOLT       KRISTEN    TERRELL    LINDSEY   
HOLT       : REEVES     CLEVELAND  IRA        COTTON     MCBRIDE   
LEONEL     : VILMA      ANNA       BRIDGETTE  KASEY     
BOOTH      : HARRELL    PITTMAN    THURMAN   
FERN       : SEARS      FOSTER     PAT       
CALDWELL   : JULIA      LES        VERNON     MITCHELL  
WILFORD    : MARGARITA 
HENDERSON  : INES       JOHANNA    KATHY      WENDI      STRONG     ROTH       HILL      
LANCASTER  : MOSES      WHITAKER   RICO       MARA       WEBB      
MARGARITO  : CLAYTON    FROST      FOREMAN    SAUNDERS  
BOLTON     : BUTLER     CHERI      RODRIGUEZ  BENTON     MADDEN     DANIAL    
BRUCE      : WIGGINS   
DENNIS     : FOSTER     KELLY     
HAYS       : WOODWARD   NANNIE     DWIGHT     COLEMAN   
SUZETTE    : PRINCE     JAIME      CRANE     
BROWN      : MILLS      DAREN      DANIEL    
KELLEY     : ANDERSON   DAPHNE     DEMETRIUS  TANYA      SALVATORE 
RODRIQUEZ  : VASQUEZ    PUCKETT    WALLER    
JERALD     : NUNEZ      CLYDE      PETER      GOODMAN    BOB        SOSA      
DELACRUZ   : MARIA      GONZALO    GIBSON     ROJAS      BRIGGS    
FREDRIC    : STEVENS    HERIBERTO 
ANA        : LEWIS      PHILIP     HICKS      BIRD       OWEN      
JIMMIE     : WILCOX     PORTER    
MYERS      : WILFREDO   BURKS     
EARL       : ANIBAL     NOELLE     ADDIE     
VIRGIE     : MARION     MONTY      ROBBY      TOBY       SLOAN      MARCI      GLOVER    
STEVEN     : NIELSEN    MARCIA     STANLEY    MCBRIDE   
ANTONIA    : WEEKS      TERRY     
LIZZIE     : SNOW       LACY      
CATHRYN    : MCKAY      CONTRERAS  ELLIOTT   
MARGERY    : BLEVINS    SHAWN      ENGLISH    ORTIZ      ANASTASIA 
SNOW       : MARISOL    LIZZIE    
WISE       : DEJESUS    GARRY      MOSS       AYALA     
AUGUSTINE  : PHILIP     ROCKY      WENDY      YVETTE    
GLORIA     : PAGE       GRAY      
CONTRERAS  : FOX        JANELLE    ERIKA      THURMAN    CATHRYN    YVETTE    
FLEMING    : ESMERALDA  DARIN      WONG      
CAMERON    : LUNA       BRANDY     LUISA      COLEMAN    FRANKLIN  
ESMERALDA  : FREDDIE    FLEMING    WHITE     
HICKS      : GABRIELA   ANA        MONTOYA    VALENTINE  CONCEPCION DELORIS   
OMAR       : CHRISTIAN  SARGENT    FRANCISCO 
GEORGE     : LINDA      BRADLEY    DORA       TORRES     WILLIE    
AURORA     : MCKAY      IRIS       MCCONNELL  LEVI       FEDERICO  
PRISCILLA  : TOBY      
CALLAHAN   : MARGUERITE BATTLE     HELENA    
ROSEMARY   : DUNN       STOUT      CURTIS    
FRANCIS    : JODIE      CHERI      THOMPSON   LANE      
TAMMY      : BAIRD      BEST       DAMIAN    
LEANN      : PAM        AHMED      MAYER      WINFRED   
ERICKA     : CANDICE    STARK      EDWIN      FLYNN      BARNETT   
JANETTE    : DARCY      GOODMAN    JULIET     BARBRA    
EARLENE    : HARRELL    ALBA       FLETCHER   WOODWARD  
JACOB      : BUCHANAN   HOMER     
CONNER     : MONTY      NICOLE     WEISS      BURTON     TEDDY      PETERSEN  
DELMAR     : DONOVAN    JACLYN     NEWMAN     MARYELLEN  MELBA      BOWMAN     PHELPS    
TATE       : LESLIE     BETTE      JOHNSON    MCBRIDE    ANNABELLE 
KIP        : MARY       LATISHA    PALMER    
WALLS      : COLLIN     ALINE     
NIKKI      : GOLDIE     TOWNSEND   ALYSON     HOGAN     
GUTHRIE    : DARYL      DAVENPORT  VAUGHN    
ASHLEE     : CARLSON    MCLEAN     CASSIE    
MASSEY     : ARRON      RICHARD    MARCIA    
TOMMY      : BARLOW     WELCH      BENTLEY    EFREN      PUGH       INGRAM     FREDERICK 
STEVENS    : HIGGINS    KENDALL    BOYER      FREDRIC    CLINT     
COLLEEN    : BERNADETTE WATERS     GALLAGHER  ANNABELLE 
VEGA       : CORY       SILAS      CURRY      GATES      AMADO      HAYDEN    
TERRY      : CLAYTON    YOUNG      CHELSEA    ANTONIA    CARR       CANDY     
NORA       : DERICK     ZAMORA    
JESSE      : LEONARDO   STARK      ROSALINDA  NADINE    
ASHLEY     : ERICK      EARLE      DANIAL    
BERNADETTE : BRENDAN    COLLEEN    JOSE       TONI       MCMAHON   
TIMMY      : JENNINGS   ETTA       VERNON     ANDREW    
JANICE     : WILLARD    JACKIE     ROSETTA    TAMMI      EARNEST   
MONTOYA    : AVIS       HURLEY     KENDALL    HICKS      DUFFY     
EFREN      : TOMMY      ROD        MAYNARD   
HERIBERTO  : CHRISTA    ISRAEL     FREDRIC    JEANNE     ROWE      
SHARON     : MILAGROS   ANDREA     FAULKNER   DUNCAN    
JUANITA    : RIOS       TIMOTHY    DONNA      PETER     
AHMED      : HARDY      KLINE      MORRIS     CARISSA    NAPOLEON   LEANN      HARRIET   
CARR       : ART        TERRY      JACKSON    LEROY     
JARROD     : HOBBS      WATERS     GALLOWAY  
STEWART    : PENNINGTON PRUITT     KAUFMAN    BURRIS    
RAY        : LEACH      GOODMAN    ROWE       MARVIN    
TRAN       : FRYE       BURTON     LELIA      MATHIS     PALMER     PETERSEN  
MCCORMICK  : ROBINSON   COLLIN     MAXINE     ERIK      
JUAREZ     : LYDIA      RUSSEL    
VALENTINE  : WALTERS    SLOAN      QUINCY     HICKS      PAT        DEWITT    
SERRANO    : ANDY       JUSTINE    HILARIO    ROCCO     
DUKE       : DEJESUS    ORR        KAUFMAN    GAY       
HECTOR     : ROSE       ROSA       MATHIS    
LACY       : JENNINGS   SOLIS      SONYA      LIZZIE     VANCE      LE         HELENA    
AVERY      : WARNER     ALEXANDER  ALTA       LENORE     LORRAINE   CROSS     
MELBA      : BRANDY     DELMAR     PARRISH    VICKI     
GOLDIE     : NOE        NIKKI      HUDSON     NGUYEN    
ISIAH      : LUCIEN     ART        JACOBS     AISHA     
JEREMY     : ROSETTA    LEBLANC   
BARBER     : JIMENEZ    JOY        CONLEY     GILL       BRIGITTE   BOYLE     
LOWE       : ENRIQUE    MIKE      
ALFONZO    : ROMERO     CANTRELL   SAMPSON    ERMA      
BUCKLEY    : LEACH      HUFFMAN    RICK       BRIDGET   
CRAIG      : BRIGHT     NEAL       JAMEL     
ROBBINS    : HIRAM      CHARITY    LAUREN     MILLICENT  SALINAS    VICKI     
MABEL      : PECK       CLAY       RICHARDSON PALMER    
RUSS       : GONZALEZ   WALSH      FRANCISCO 
KIDD       : MERCEDES   TUCKER    
FAULKNER   : VERA       HINTON     SHARON     BREWER     SHANNON    ALBERTO   
SAMPSON    : FROST      RICARDO    ALFONZO    EARNEST   
ANDREWS    : MERCEDES   PAULETTE   SCHULTZ    CRANE      HURST      BARBRA    
SALINAS    : ROBBINS    SHANNON    JAMAR     
DELANEY    : HIRAM      MICAH      ISABELLE   POTTS      ERICKSON   FAITH      RAUL      
AVA        : HERRERA    CARMELO    JESSICA    KENTON     TRUDY     
NEIL       : DAPHNE     PAM        VICTOR     LOTT       ROJAS      KEVIN     
RAYMOND    : LEACH      ADKINS     CHRISTINE  PASQUALE   LORAINE   
BUCHANAN   : MARION     MARIA      KERRY      JACOB      AYALA     
EMILY      : RYAN       THADDEUS  
CONCEPCION : MARIE      MCFADDEN   JOSEPH     HICKS      SCOTTIE   
KAUFMAN    : WILCOX     STEWART    DUKE       DONALD    
BRADLEY    : GRIFFIN    CARNEY     GEORGE     ROOSEVELT 
JAYNE      : DANIELLE   JEAN       MAYNARD   
SIMONE     : COMBS      SILAS      MERLE      DAREN      CURTIS    
SHEPHERD   : LUCIANO    WILEY      LEON      
WILLIAMS   : DAVID      VALENZUELA
MCINTYRE   : SOTO       CONLEY     DEAN      
WILKINSON  : ROBINSON  
CAROLINE   : MCLAUGHLIN CANTRELL   DANIELS    CLINT     
HOMER      : CHELSEA    EVERETT    ANNETTE    JACOB      TERRENCE  
PARRISH    : TRICIA     TARA       MELBA      DARRYL    
COX        : JACLYN     TUCKER     DAWN      
STACI      : ROBBIE     ROSS      
JACOBS     : BARNES     ISIAH      FRANKLIN  
ROSARIO    : BURGESS    MARCUS     JEAN       KELLER    
MEADOWS    : WYATT      JEAN       MARSH      DICK       BULLOCK   
BRADSHAW   : WEEKS      GLADYS     FOWLER     TAMMIE     CROSBY     STEPHENSON
MUELLER    : INES       SANTIAGO   WALSH      DEANA      GERARDO   
HAZEL      : COOLEY     GILES      JILLIAN   
JARRED     : CRYSTAL    ALTA       FLORES     WOODARD    WASHINGTON RANDALL    HUBBARD   
BRUNO      : LENORE     HENRIETTA  HALL       KENDRA    
SWANSON    : MILLIE    
CARROLL    : PAGE       TAMERA     LOURDES    GRETA     
VALENCIA   : DILLON     KYLE       HAYDEN    
PRESTON    : LEANNE     BLANCHARD  DAVID      MUNOZ     
PEREZ      : HEATH      CAROL      MILO       WINFRED    EVE       
MARCELO    : TILLMAN    EDMUND     HENRY      ALYSON     MANNING    ALI        LIDIA      MCMAHON   
MILLS      : EDMUND     MILLIE     BROWN      MATTHEWS  
GENEVA     : HUNTER     RICHARDSON SHERRI    
ERMA       : IGNACIO    MORRIS     CROSS      HERMINIA   BRIANA     ALFONZO    FINLEY    
TINA       : GARTH      BRIAN      FLORINE    BARKER    
TOWNSEND   : CONLEY     RUTLEDGE   MARIANA    NIKKI     
BRENTON    : KNOWLES    HERSCHEL   PATSY      TONI      
DELORIS    : POTTS      HICKS     
CANTU      : HINES      LUCIANO    TANYA     
PAYNE      : ESTES      LAUREN     ROBBY      GONZALEZ   XAVIER     GLADYS     MOSS       KOCH      
PAYNE      : LANG      
ANTHONY    : ED         CLARA      JEWELL     NADINE    
DELGADO    : KOCH       HOGAN      MAURICE   
MCCRAY     : DORIS      ELLIS      CANTRELL   HINTON     ELVIRA     JESSIE     NIEVES    
FREEMAN    : FANNIE     MAGGIE     COOK       JULIAN     MCGOWAN   
ESTEBAN    : ALVIN      BRIGITTE  
GRACE      : FLOSSIE    WILL       SIMS       PETERSON   MITCHELL  
ADAMS      : DILLON     AMANDA     ENGLISH    RONNY      ALBERT    
RICKY      : MAE        IAN        FRANKIE   
LORENA     : WARREN     FREDDIE    JARED      ENID      
KARLA      : TABATHA    LORI       SANFORD    REGGIE    
WOODARD    : MERCEDES   ADELINE    JARRED     WASHINGTON JOSH       MONROE    
JARED      : LEONARDO   GILL       GIOVANNI   ANNMARIE   EDGARDO    LORENA     EARLE     
WELLS      : ROBINSON   GRIMES     JORDAN    
NEWTON     : WILLIS     ERNESTINE  ENID       ALFONSO    REGINA    
BURRIS     : AMANDA     ANNETTE    STEWART    JILLIAN    HOLLAND   
MARCY      : TYREE      CROSS      NIEVES     RONNY      ALFONSO   
BENITO     : WALSH      ANNETTE   
LARSON     : WEISS      WEEKS      COOK      
VICKI      : KATHERINE  ROBERTA    MELBA      ROBBINS   
DONALD     : GONZALEZ   MOSS       KAUFMAN    AUBREY     PAT        CASEY     
WENDY      : MONICA     JOHNS      HANEY      AUGUSTINE  DANA      
AUBREY     : FIELDS     MARTINEZ   DONALD     JEANNE    
DAVID      : LETICIA    WILLIAMS   PRESTON    DARRYL     LORAINE   
COMPTON    : BRENDAN    CHARLIE    CECIL      JULIO      CRANE      OBRIEN     GIBBS     
PUGH       : JARVIS     ABEL       TOMMY      CHUCK      TABITHA   
MENDOZA    : RICHARD    TARA       CORINNE    HARRISON   MINNIE     DEVON     
KEITH      : PAM        JOSEPHINE 
MERLE      : EMORY      SILAS      ALTON      FRIEDA     SIMONE    
BREWER     : FAULKNER   TORRES     ORTIZ      CAROL     
VERNON     : CALDWELL   TIMMY      TURNER    
SCOTTIE    : RAMOS      DINO       MARA       NANETTE    CONCEPCION ERICKSON   RAPHAEL    CORTEZ    
ALICIA     : SANTIAGO   STEELE     ROCKY      MOISES     PHILLIP   
EARLE      : ANIBAL     ODOM       ASHLEY     JARED     
IAN        : HERBERT    RICKY      TANNER    
JEAN       : MARTINEZ   JAYNE      ROSARIO    MEADOWS   
SAUNDERS   : MARGARITO  HEAD      
DECKER     : ROB        JOHN       NICHOLS    BOYLE      GIBBS     
JOSUE      : VONDA      PETTY      DYER       BULLOCK   
SYKES      : WITT       KENT       ETHEL      RAUL      
MILDRED    : ROB        SANTIAGO   DARRELL    WOODWARD   SUSAN      ALI       
SYBIL      : OCONNOR    DENA      
DEANNE     : STACIE     CARLENE    KERRY      NANNIE     CHRISTINE 
BONNER     : DORIS      WALTERS    HANNAH     THOMPSON  
NIELSEN    : COPELAND   STEVEN     SHARRON    POOLE     
ENGLISH    : NETTIE     MARGERY    ADAMS      STACY     
HOUSE      : GILMORE    ROBINSON   DEWAYNE    CAROLYN    IRA       
LEONARD    : WEEKS      FERNANDEZ  DUNCAN    
WATERS     : COLON      HINTON     VICTORIA   COLLEEN    JARROD     GRACIELA  
BENTON     : IRIS       GARTH      VELMA      CECELIA    BOLTON    
HARMON     : GONZALEZ   PACHECO    EVANGELINE
DIXON      : EMILE      BARNETT    RANDOLPH   GIBBS     
ISABELLA   : TAYLOR     VAUGHN    
GARNER     : THOMAS     ALI        CORRINE    TYLER     
MOODY      : WELCH      DEANDRE    ROCCO      BURTON     MARIANA    BRIGGS    
LUISA      : VILMA      PARK       CAMERON    SANFORD    LOTT       SHARRON   
PUCKETT    : VASQUEZ    RODRIQUEZ 
WALL       : LANGLEY    AMANDA     DAPHNE     LENORE     GALEN      LEMUEL     PALMER    
DEMETRIUS  : KELLEY     MCLEAN     LAWANDA    QUINTON   
MOHAMED    : GINGER    
GIBSON     : CHANEY     JAMAAL     PATEL      DELACRUZ  
SOLOMON    : MCCONNELL  HOPKINS    MICHEAL    HODGE     
GOOD       : WEISS      CANTRELL   DYLAN      LENORA    
ELVA       : ANNIE      ANDREA     VANCE     
NIEVES     : ERICK      ROBT       MCCRAY     MARCY      NOEMI     
JEWELL     : AVIS       THURMAN    ANTHONY    MARKS     
JOSE       : JUSTINE    PATEL      BERNADETTE NAVARRO   
DIXIE      : MANUEL     FULTON     LINDA      KENTON    
GRAY       : HIGGINS    FREDDIE    GLORIA     MITCHELL  
FULLER     : LYMAN      FRANCESCA  HOLCOMB    JASPER     ROBT       FLYNN     
ELDON      : NETTIE     WILLIS     WENDI      BLAKE     
JESSICA    : BLEVINS    AVA        ARNULFO   
GILLESPIE  : LENORA     MACK       TRENT     
ALEXANDRA  : BAKER      RICHARD    ROCCO      ADAM       HOLDER     SANFORD    KRAMER     KEVIN     
IRA        : COPELAND   CLARA      HOLT       HOUSE     
BIRD       : RIVERA     ANA       
TAMMIE     : BENJAMIN   MCLAUGHLIN FREDDIE    ERNESTINE  BRADSHAW   ERNIE     
RORY       : MCKAY      MCNEIL     VICTOR    
MERCER     : WEAVER     CHANCE     ELINOR     PHELPS    
STANTON    : IRIS       DONOVAN    BRIDGETTE  MOLINA     ROMAN     
GRACIELA   : STACIE     BALDWIN    HOLMAN     CHANG      SEBASTIAN  WATERS    
COLLIN     : JANINE     WALLS      MCCORMICK  WASHINGTON
BOBBI      : TOM        DIANE      SHEPARD    LENORA     REGINA    
MARKS      : REBEKAH    JEWELL     SHERMAN   
ADKINS     : RAYMOND    GUZMAN     ANGELITA  
HERMAN     : OLGA       COOK       KRISTINE   CONSUELO   HOGAN     
IRVIN      : NITA      
PATRICK    : GONZALEZ   ELLIS      ANDREA     KRISTINA   TERRENCE   MCCLURE   
VALENZUELA : HOOPER     HEATH      WILLIAMS   STEVENSON  HILL      
WILKERSON  : PAGE       SIMON      HURST     
ANTONIO    : PERCY      BLANCHARD  YVETTE     GREENE    
HERSCHEL   : MONTGOMERY PIERCE     MILLER     BRENTON   
DWIGHT     : GLENN      HARDY      HAYS       JILLIAN    CONSTANCE 
HURST      : FLOYD      SHERYL     ANDREWS    WILKERSON  JOAN       JOYNER     HEAD      
PAT        : FERN       VALENTINE  DONALD     BULLOCK    FRANKIE   
LAURI      : MCKAY      FRY        CHANDLER   LUPE      
HENRY      : RASMUSSEN  BEACH      MARCELO    LEON       RANDOLPH  
MARSH      : JIMENEZ    MEADOWS    SANFORD    CASTRO    
NOEMI      : BERGER     NIEVES     JAY       
CHRISTIAN  : HENSON     MARA       OMAR       WILLIE     DEAN      
SHANNON    : PERCY      NICOLE     KRISTIE    DYER       FAULKNER   SALINAS   
ARNULFO    : LILA       PITTMAN    CHANG      JESSICA    DURAN     
SETH       : DUNLAP     MITCHELL   CHARLES   
INGRAM     : MARA       RICARDO    TOMMY      FLYNN     
ALFRED     : CECELIA   
CHRISTINE  : KRISTINA   RAYMOND    DEANNE    
CINDY      : SOSA       MARTIN    
DAVENPORT  : GARRY      GUTHRIE    JACKSON    LLOYD     
SANFORD    : KARLA      LUISA      ALEXANDRA  MARSH      MUNOZ     
COLEMAN    : BURGESS    COOLEY     HAYS       CAMERON    JAMAR      CLARENCE  
JIM        : FOX        ELMA       SPENCE     ENRIQUE    BLAIR     
GENARO     : TRICIA     SANTANA    GRAHAM    
CORINNE    : MENDOZA    EDWIN      CLINT     
ELBERT     : BRIAN      LEANNE     VASQUEZ    HORN       AL        
DAREN      : DONOVAN    MCMILLAN   BROWN      SIMONE     WHITNEY   
YVETTE     : ALEXANDER  FIGUEROA   MALDONADO  AUGUSTINE  CONTRERAS  ANTONIO    CLAUDIA   
MORROW     : ANIBAL     CEDRIC     STRONG     STEVENSON 
GUZMAN     : KLINE      HINTON     PORTER     ADKINS     SHARRON    MCGOWAN   
NORMA      : SLOAN      TIMOTHY    DEANA      LOTTIE     FOSTER     WHITNEY    SHERMAN    BETH      
NORMA      : BOWEN     
DAMIAN     : BALLARD    TAMMY     
HUMBERTO   : FREDDIE   
DICK       : ED         MEADOWS    MCGOWAN   
SONNY      : GERARDO    CORNELIUS 
MATHIS     : KEVEN      EVANGELINA PRUITT     TRAN       HECTOR     CHARLES   
JULIET     : WARNER     JONI       JANETTE    DUFFY     
KRISTEN    : LYMAN      CLEVELAND  GALLOWAY  
SARGENT    : HART       JOY        CLAUDETTE  OMAR      
MCCARTY    : SPENCE     ERIKA      ART        TABITHA    GRAHAM     CROSBY     TONIA     
TANIA      : LESLIE     ROBLES     MARYELLEN  ODOM      
JULIE      : MILAGROS   BARRERA    WENDI     
RONNY      : YANG       HURLEY     ADAMS      MARCY      SOSA       CEDRIC    
HENDRICKS  : LINDSAY    WENDI     
BOWMAN     : ELIZA      DELMAR     HOOD      
HARRISON   : KEVEN      POPE       MENDOZA    BRIDGET   
DORA       : INGRID     GEORGE     JOAN       COTE      
ELIJAH     : ERICK      STEELE     MILES      MARCEL    
ERICKSON   : KATY       DELANEY    SCOTTIE   
TEDDY      : WARD       CONNER     MACIAS     WONG      
REFUGIO    : HOBBS      EDWIN      CHUCK      GONZALES   LANG      
LOTT       : ANIBAL     HARDY      NEIL       LUISA     
WATTS      : PATE       GILBERT    LORRAINE   BARTON    
GILES      : RUTLEDGE   BOBBIE     COLLIER    WEAVER     HAZEL      MATTHEWS   REINALDO   FERRELL   
VAN        : LORRAINE   MATTHEWS   TRAVIS    
BULLOCK    : ROBINSON   MEADOWS    JOSUE      PAT       
GOODWIN    : VALERIE    COOKE      SILVA      PIERCE     ANGELITA  
TORRES     : MAXWELL    MILAGROS   ANDREA     GEORGE     BREWER    
WALLER     : WALTERS    BARNES     DEENA      RODRIQUEZ 
RAPHAEL    : CHANEY     CHARLOTTE  NITA       VICTOR     SCOTTIE    LOGAN     
ELLIOTT    : ISABELLE   CATHRYN    MOSLEY    
MACDONALD  : LEVI       MILES      HARRIS     SANCHEZ   
JAMAR      : ERIN       DANIELLE   LOURDES    SALINAS    COLEMAN    REGINA    
LEMUEL     : LILA       BARRY      REBEKAH    COLLIER    WALL      
DARIN      : GARRY      LETICIA    FLEMING    PALMER    
ROJAS      : ARIEL      RAMOS      MCCONNELL  DELACRUZ   NEIL       EVE        KRYSTAL   
BOYLE      : BARBER     DECKER     MAXINE    
KENTON     : PEARSON    JANINE     AVA        DIXIE      WEBB      
MOISES     : ALICIA     SHERMAN   
AUTUMN     : HOOPER     ARIEL      PARK       WILBUR    
ROOSEVELT  : BELL       BRADLEY    KNIGHT     EVE        MCCLURE   
QUINN      : ROB        SCHROEDER 
NAVARRO    : WILFREDO   LETICIA    CRANE      JOSE      
FAITH      : MONICA     FROST      DELANEY   
CAIN       : MCKEE      SUSAN      DYER      
CHANCE     : LUCILLE    TODD       VINCENT    MERCER     CHARMAINE 
BRANDI     : LAUREL    
ROSALINDA  : GLENN      REEVES     JESSE      SANTANA   
PATSY      : LEANNE     HENSON     FOWLER     BRENTON    OLSON     
SOSA       : JERALD     CINDY      RONNY      REYNOLDS  
HODGE      : MADELINE   SOLOMON   
NANCY      : PHILLIPS   WOODWARD   LORIE      MICHAEL   
LON        : SIMON      MALDONADO 
TERRELL    : KNOWLES    JOANNA     CLEVELAND  FLYNN      RUSSO     
MERRITT    : JILL       GRIFFIN    ALTA      
MATTHEWS   : DUSTY      MILLS      GILES      VAN        HELENA    
CEDRIC     : DAPHNE     MORROW     RONNY      BARNETT   
MAXINE     : STEPHENS   FLOYD      DARRELL    MCCORMICK  BOYLE     
SUSIE      : WARNER     ARRON      MANNING    BERNARDO   PARSONS   
HALL       : PECK       BRUNO      GLOVER    
ALYSON     : MCNEIL     NIKKI      MARCELO    HERRING    ALFONSO   
CHERRY     : WALTON     OSCAR      ISRAEL     NOELLE     EVANGELINE CASSIE    
CORTEZ     : FLETCHER   RYAN       SCOTTIE    ESTELLA    MARCEL     MADDEN    
EVAN       : DEJESUS    HULL       ARMSTRONG  PHELPS    
PHILLIP    : REYES      GREGORY    ALICIA    
SUSANNA    : BORIS      GALLOWAY  
MANNING    : MADELINE   MARCELO    SUSIE      COFFEY    
CARDENAS   : MICHAEL   
OTTO       : CHANEY     ROBT       FORREST   
KYLE       : VILMA      VALENCIA   WELDON    
EARNEST    : WEISS      POPE       JANICE     SAMPSON   
OLSEN      : DORIS      RAMOS     
WILLIE     : COOKE      GEORGE     CHRISTIAN 
SCHROEDER  : RICHARDS   LORIE      QUINN      MAYNARD   
TONI       : MCCALL     ERNESTINE  BERNADETTE BRENTON    HOFFMAN   
BILLIE     : AUSTIN     THOMAS     HOLCOMB    ERNESTINE 
OLSON      : DIONNE     DILLON     MERLIN     PATSY     
ESTELLA    : KNOWLES    CORTEZ    
ALBERTO    : LEVI       THOMAS     FAULKNER  
SHARRON    : LEACH      SCHNEIDER  MILLER     LULU       WEAVER     RUSSELL    NIELSEN    LUISA     
SHARRON    : GUZMAN    
EDWIN      : SANTIAGO   HUGHES     ERICKA     CORINNE    REFUGIO   
WHITNEY    : CECELIA    DAREN      NORMA      ERNA      
CURRY      : BETTE      VEGA       POOLE     
HUFFMAN    : BUCKLEY    LACEY     
TERENCE    : INES       CARISSA    KENDALL   
SANTANA    : MILAGROS   GENARO     ROSALINDA  BLAIR      STEPHENSON SHERRI    
ROMAN      : STEELE     HENSLEY    STANTON    MICHAEL    BARTON    
KENDRA     : WEBER      JACLYN     FOREMAN    BRUNO     
PETERSON   : GRACE      MADDEN    
ROD        : ROBBIE     XAVIER     LETICIA    EFREN     
BASIL      : MOSLEY    
RICK       : URSULA     KIM        NICHOLS    ROSS       BUCKLEY    SANCHEZ    HUNT      
MICHAEL    : BARLOW     MCLAUGHLIN DARRELL    NANCY      CARDENAS   ROMAN      REILLY    
BATTLE     : NUNEZ      PITTS      FRY        DOMINGO    CALLAHAN  
COTTON     : ANTONE     NAPOLEON   HOLT       LESSIE    
BERNARDO   : NUNEZ      DILLON     KLINE      NETTIE     SANDOVAL   SUSIE      INA       
WASHINGTON : CARSON     TREY       JARRED     WOODARD    COLLIN     MACIAS    
JILLIAN    : LENARD     COOLEY     HAZEL      BURRIS     DWIGHT    
TERRENCE   : ROSS       HOMER      PATRICK    CALVIN     QUINTON   
HERRING    : ALYSON    
FREDERICK  : HOLMAN     LOTTIE     TOMMY      HARPER    
DYLAN      : LILIANA    JEFFERSON  WOLFE      GOOD      
SIMPSON    : WILBUR     NELDA      DUNLAP     SAVAGE     ANNABELLE 
BRADFORD   : HOOPER     LANE       COLLINS    LESSIE    
ERIK       : COLON      DUNN       MCCORMICK  ESTRADA    MONA      
CALVIN     : TRENTON    MEREDITH   COMBS      ZAMORA     TERRENCE  
MARIANO    : HARRINGTON KRISTINE  
BARR       : VILMA      HANSON     ROSE       MYRA       PHELPS    
ORTIZ      : LENARD     VERA       KATHY      MARGERY    BREWER    
DON        : THOMAS    
THADDEUS   : VICTORIA   EMILY      FERRELL    DANA      
SCHWARTZ   : WIGGINS    ARTHUR     BEASLEY   
AYALA      : GRETA      WISE       BUCHANAN   FERRELL   
HUDSON     : PAMELA     HINES      GOLDIE    
TRUDY      : MCLAUGHLIN KARYN      AVA        SALVATORE 
ARTHUR     : KOCH       SCHWARTZ  
COFFEY     : PERRY      JASPER     MANNING    TRENT     
MAYER      : WILL       SAMUEL     LEANN     
NADINE     : JESSE      ANTHONY   
DUNCAN     : JARVIS     GUY        MEDINA     THOMPSON   SHARON     LEONARD    FERRELL   
REGGIE     : MAVIS      KARLA      CURTIS    
BLAIR      : MARK       JIM        SANTANA   
SHERMAN    : HERRERA    DONOVAN    HIGGINS    MARKS      NORMA      MOISES     CORNELIUS 
LENORA     : GOOD       GILLESPIE  BOBBI      ROTH      
CHUCK      : DARNELL    PUGH       REFUGIO    ANDREW    
GATES      : KATHY      VEGA       HOWELL    
SOFIA      : KURT      
FERDINAND  : MCKAY      BALDWIN    SHANA      MARISSA   
ISIDRO     : MEREDITH   GARTH      CANTRELL   MARSHALL  
KELLER     : PEARSON    TODD       DENIS      ROSARIO   
CANDY      : MAC        TERRY     
JAY        : PERCY      KIM        NOEMI     
TURNER     : TRENTON    MOLLIE     VERNON    
MUNOZ      : PRESTON    SANFORD   
VARGAS     : JIMENEZ    RUTLEDGE   MARSHALL  
WENDI      : HOLDER     HENDERSON  ELDON      JULIE      HENDRICKS  MCLEAN     JULIAN    
RANDALL    : JARRED    
JOAN       : MILAGROS   WEBER      NUNEZ      SARA       RONALD     HURST      DORA      
ERNA       : GINGER     WHITNEY   
VANCE      : HOUSTON    SEARS      ED         LACY       ELVA      
AMADO      : CLAUDETTE  VEGA       CORNELIUS  ROTH      
CARVER     : WALDO      TARA       NOEL      
LACEY      : AUSTIN     DANIELLE   MALDONADO  HUFFMAN    LYNN      
INA        : LESLIE     BERNARDO  
HARRIET    : XAVIER     AHMED      KELLY     
AISHA      : WEISS      ISIAH     
ALI        : LESLIE     DODSON     CASANDRA   KRISTINA   MOLINA     MARCELO    MILDRED    GARNER    
FORREST    : LESLIE     WOLF       BROCK      LORENZO    KENNEDY    OTTO      
ADDIE      : WOLF       LANE       MAE        EARL      
GALLAGHER  : COLLEEN   
KNIGHT     : ELVIRA     NOELLE     ROOSEVELT 
KRISTINE   : WALTERS    DODSON     FROST      HERMAN     MARIANO    LORAINE   
ROBERT     : ALBA       BURT       HOFFMAN    CARLA     
CLARENCE   : STACIE     VERN       COLEMAN   
WHITE      : CRYSTAL    ESMERALDA 
KERRI      : NOLAN      KATHLEEN   GINGER    
HOFFMAN    : TONI       ROBERT     LIDIA      TANNER    
TABITHA    : PUGH       MCCARTY   
DURAN      : TAMMI      ARNULFO   
CORNELIUS  : SONNY      SHERMAN    AMADO      LINDSEY   
HOWELL     : EMORY      RICHARD    DANIELS    GATES      LYNN      
CHARMAINE  : HEATH      CHANCE    
ERNIE      : KATHARINE  TAMMIE    
MARSHALL   : ISIDRO     VARGAS     COTE      
HOOD       : CRYSTAL    LYDIA      HOPKINS    BOWMAN     ESTRADA   
HARRIS     : KATHERINE  LANE       MACDONALD 
FRANKIE    : GERARDO    RICKY      PAT       
LAWSON     : RAMOS     
DEWITT     : WALTON     GLADYS     VALENTINE 
LEON       : CHANG      ED         SHEPHERD   HENRY     
SANCHEZ    : LANA       JILL       BROCK      HERMINIA   WILBUR     MACDONALD  RICK       RODERICK  
GONZALES   : NAPOLEON   REFUGIO   
JEANNE     : TRENTON    CHANEY     TABATHA    DENA       CHAVEZ     NIGEL      HERIBERTO  AUBREY    
LIDIA      : WILLIS     SONYA      MARCELO    HOFFMAN    SAVANNAH  
CUMMINGS   : FREDERIC   SAMUEL     NAPOLEON  
HAWKINS    : MARK       HERBERT    PHILLIPS   ANASTASIA 
LE         : MADELINE   JANINE     LACY      
ANASTASIA  : LITTLE     FANNIE     CARLO      FRANCES    MARGERY    HAWKINS   
ROYCE      : CHARLOTTE  DARRELL    CARLO      REESE     
BURKS      : STARK      MYERS     
FLYNN      : CHARLIE    JOHNATHAN  ERICKA     FULLER     INGRAM     TERRELL   
DALTON     : ANDY       TOBY       FRANKS    
STRONG     : ODELL      PATEL      AURELIA    HENDERSON  MORROW     STACY      MONROE    
CLINT      : MICHEAL    INGRID     STEVENS    CAROLINE   CORINNE   
LORNA      : FISCHER    HIGGINS    LAMBERT   
ENID       : LORENA     NEWTON     JAMEL     
JACKSON    : BRADLY     LORRAINE   CARR       DAVENPORT 
RICHARDSON : ROXANNE    KERI       ELIZA      MABEL      GENEVA     BLAKE      SAVANNAH  
BRYANT     : NOLAN      PAM       
CLEMONS    : INES       IRWIN      SPENCE    
CHARLENE   : DODSON     BAIRD      TANNER    
ROWE       : URSULA     HERIBERTO  RAY       
REINALDO   : LANA       MARIBEL    GILES     
JOHNNIE    : LUCILLE    TASHA      CARISSA   
TANYA      : ELIZA      DAWN       RYAN       KELLEY     CANTU     
COTE       : GARRETT    JOANNA     CHERI      LES        DORA       MARSHALL   KEVIN     
POOLE      : TRENTON    CHRISTI    BALDWIN    LARSEN     WHITAKER   ANNMARIE   NIELSEN    CURRY     
ONEIL      : MAVIS      CRYSTAL    SHERYL     ELISEO    
HELENA     : WALTON     CALLAHAN   LACY       MATTHEWS  
HUBBARD    : GLENN      HEIDI      JARRED    
MARCEL     : LANDON     RIOS       ELIJAH     CORTEZ    
BRAY       : DEVON     
DAMON      : MARISOL    JOHN       JOHNS      WEEKS     
AIDA       : MONICA     KENT       MCCULLOUGH DUSTY     
BLAKE      : CLARK      WHITLEY    ELDON      RICHARDSON BARNETT   
GEORGIA    : LEONOR     KNOX      
NELDA      : FISCHER    LULU       SIMPSON    JOYNER     HAYDEN    
GRAHAM     : ABE        REESE      GENARO     MCCARTY   
HOWARD     : ISABELLE   GABRIELA   CRANE     
STEVENSON  : VALENZUELA MORROW     CONSUELO  
STACY      : ENGLISH    STRONG    
CAROL      : WOLFE      PEREZ      BREWER    
MADDEN     : VELMA      FRANKS     DONA       BOLTON     CORTEZ     PETERSON   MONA      
ROSALES    : ETTA       PORTER    
ALISSA     : RICO       JULIAN     LYNN       MERRILL   
RODERICK   : LINDSAY    SANCHEZ    PASQUALE  
NOEL       : DOYLE      CARVER     STEPHENSON
MCLEAN     : WOODWARD   ENRIQUE    ASHLEE     DEMETRIUS  WENDI     
CONSUELO   : VELASQUEZ  WHITFIELD  HERMAN     STEVENSON 
CARLA      : JENNINGS   HERBERT    ROBERT    
KASEY      : HIRAM      PARK       REYNA      LEONEL     RACHAEL   
MORENO     : ERIN       DARNELL    LINDSEY   
BARNETT    : ERICKA     DIXON      CEDRIC     BLAKE     
ANDREW     : JOSEPH     WEAVER     ARMSTRONG  MAYS       TIMMY      CHUCK     
SAVANNAH   : LIDIA      RICHARDSON
DUNLAP     : OCONNOR    SETH       SIMPSON   
MITCHELL   : FRY        SELENA     WIGGINS    DONNA      CROSS      CALDWELL   GRACE      GRAY      
MITCHELL   : SETH      
HEWITT     : KATY       GLENN      BARRERA    MALLORY   
BARBRA     : KERI       CHAVEZ     JANETTE    ANDREWS   
JOSH       : WOODARD   
MILO       : HOBBS      SOTO       PEREZ     
MACK       : MILLICENT  HOLCOMB    DAWN       FOWLER     GILLESPIE  GLOVER    
ODONNELL   : ANNETTE   
JOHNSON    : JAMAAL     KRISTINA   KENDALL    HENRIETTA  TATE      
MINNIE     : PORTER     PACHECO    MENDOZA   
CASTRO     : MONTGOMERY HOUSTON    WOLFE      MARSH     
JAMEL      : ODESSA     CRAIG      ENID      
HOLLOWAY   : LANG      
LANG       : PAYNE      REFUGIO    HOLLOWAY   CORRINE   
SALVATORE  : WARNER     KELLEY     TRUDY      HARPER    
RANDOLPH   : BALDWIN    MAGGIE     DYER       DIXON      HENRY     
TRAVIS     : DANIELLE   NETTIE     VAN       
DEVON      : OSCAR      BARTLETT   MENDOZA    BRAY      
FRANCISCO  : HERBERT    KRISTIE    PIERCE     BOYD       POPE       OMAR       RUSS       POLLARD   
CORRINE    : WOLFE      DONNA      CONRAD     GARNER     LANG       COLLINS   
HOGAN      : HAROLD     NIKKI      DELGADO    HERMAN    
DANIEL     : HATFIELD   ALEXANDER  BROWN     
ANGELITA   : MALDONADO  ADKINS     GOODWIN   
MARISSA    : FERDINAND 
OBRIEN     : CRAFT      COMPTON   
WINFRED    : CRISTINA   BAKER      RIOS       LEANN      PEREZ     
CLAUDIA    : CANDICE    ALVIN      JORDAN     YVETTE     DELBERT    JOSEPHINE 
GIBBS      : WALTERS    ROSE       PAULETTE   SHEPARD    COMPTON    DECKER     DIXON     
FERRELL    : RICO       GILES      THADDEUS   AYALA      DUNCAN    
ELINOR     : BYRD       FORBES     FRIEDA     ANNMARIE   LORENZO    MERCER    
LUCY       : PATE       PERCY      LEROY     
GAY        : DUKE       WEBB      
MOSLEY     : BARKER     ELLIOTT    BASIL     
FUENTES    : DIANE     
JULIAN     : DOMINGO    REESE      FREEMAN    WENDI      ALISSA    
PASQUALE   : CHRISTI    HARRELL    RAYMOND    RODERICK   LESSIE    
LEROY      : GERARDO    NOELLE     CARR       LUCY      
DELBERT    : DIAZ       BUDDY      PRUITT     CLAUDIA   
DANIAL     : MCLEOD     TRACEY     HILARIO    BOLTON     ASHLEY    
PHELPS     : ODELL      DELMAR     MERCER     EVAN       BARR      
MAYNARD    : AMANDA     TREY       EFREN      JAYNE      SCHROEDER  BETH       ESTRADA   
JOYNER     : GLENN      TRACEY     TUCKER     LAMBERT    SONYA      BENTLEY    EVANGELINA HURST     
JOYNER     : NELDA     
CURTIS     : MAXWELL    TOM        ROSEMARY   SIMONE     REGGIE    
CONSTANCE  : LESLIE     FLOYD      SHEPARD    DWIGHT     DARRYL    
TANNER     : LESLIE     JIMENEZ    IAN        HOFFMAN    CHARLENE  
KRAMER     : HILARIO    ALEXANDRA  LAWANDA   
MCGOWAN    : MALDONADO  FREEMAN    GUZMAN     DICK      
SELLERS    : BARLOW     STUART     HULL      
SHELLEY    : AMIE       AMANDA     MERRILL   
ALFONSO    : CRYSTAL    GARTH      NEWTON     MARCY      ALYSON    
CROSBY     : IRIS       CATHERINE  BRADSHAW   MCCARTY   
PARSONS    : HINTON     BURCH      DYER       SUSIE      BEASLEY   
HELGA      : MCDONALD   TARA       GALEN     
ALINE      : ABE        MOLLIE     MARA       WALLS     
GALLOWAY   : JOY        WOODWARD   LEBLANC    RODRIGUEZ  JARROD     KRISTEN    SUSANNA   
LINDSEY    : CLEVELAND  CORNELIUS  MORENO    
JOSEPHINE  : ELOISE     KEITH      CLAUDIA    DUFFY     
BERNADINE  : MCDONALD   MCKAY      RONALD    
OWEN       : FANNIE     SILVA      ANA       
CASEY      : PAGE       NICOLAS    DONALD    
TYLER      : SILAS      KATHARINE  GARNER    
MARCIA     : COOLEY     LETICIA    STEVEN     MASSEY    
COLLINS    : ROSETTA    DEWAYNE    MILES      BRADFORD   CORRINE   
MONROE     : BOB        WOODARD    STRONG    
MARVIN     : RICE       RAY       
DUFFY      : WHITFIELD  MONTOYA    JULIET     JOSEPHINE  STANLEY   
JOHNSTON   : PEARSON    FISCHER    HOLLIE     BERGER    
KELLY      : CHANEY     GLASS      DENNIS     HARRIET   
RUSSO      : LESTER     LUCILLE    BARRERA    BEACH      TERRELL   
BRIDGET    : SAM        ROBBIE     WELCH      KURT       BUCKLEY    HARRISON  
LYNN       : RAMIRO     ODESSA     MCNEIL     LACEY      HOWELL     ALISSA    
BEASLEY    : NEWMAN     SCHWARTZ   PARSONS    NATASHA   
ETHEL      : ROY        RUSSELL    SYKES      LLOYD      TONIA     
MACIAS     : TEDDY      WASHINGTON HEAD      
FINLEY     : HAMILTON   JULIO      FRANCESCA  ERMA      
BARTON     : WARREN     THURMAN    WATTS      ROMAN     
RUSSEL     : JACKIE     HERRERA    STEELE     JUAREZ    
PALMER     : HERMINIA   KIP        TRAN       MABEL      WALL       DARIN     
GLOVER     : VIRGIE     HALL       MACK      
LAWANDA    : PATE       BENJAMIN   ANITA      DEMETRIUS  KRAMER    
EVE        : ANTONE     FOX        PEREZ      ROJAS      ROOSEVELT  EVANGELINE
GILBERTO   : ROSA      
LLOYD      : PERCY      HUNTER     MCFADDEN   DAVENPORT  ETHEL     
HEAD       : SAUNDERS   HURST      MACIAS     LESSIE    
PARKS      : RAMSEY     WALTERS    LEACH      COOKE      ELLIS      KARYN     
MARTIN     : GERARDO    CINDY     
SAVAGE     : DUNN       ADAM       MARIANA    SIMPSON   
MAURICE    : COPELAND   BELL       DELGADO    KERR      
STEPHENSON : MOLINA     BRADSHAW   SANTANA    NOEL      
NICHOLSON  : BEAN       MOLINA    
BRIGGS     : KNOX       TUCKER     FLETCHER   HENRIETTA  DELACRUZ   MOODY     
REYNOLDS   : CASTILLO   PRINCE     HURLEY     SOSA       RENA      
REILLY     : CLAYTON    WHITAKER   DONA       NANETTE    MICHAEL   
EVANGELINE : MEREDITH   JACLYN     WIGGINS    HARMON     CHERRY     EVE       
BRYAN      : BARNES    
NGUYEN     : ROMERO     KATHARINE  GOLDIE    
WEBB       : LANCASTER  KENTON     GAY       
ROTH       : HENDERSON  LENORA     AMADO      BAUER     
KANE       : LUCIEN     LYDIA      ROSE      
ALBERT     : FIGUEROA   ADAMS     
LESSIE     : COTTON     BRADFORD   PASQUALE   HEAD      
ANGIE      : FISCHER    WILFREDO   JOYCE     
DEAN       : FREDDIE    MCINTYRE   CHRISTIAN  TY        
MCCLURE    : RUTLEDGE   LORENZO    PATRICK    ROOSEVELT 
STANLEY    : WITT       WELCH      EDITH      WHITFIELD  ROBIN      STEVEN     DUFFY     
MCBRIDE    : SOTO       HUGHES     HOLT       STEVEN     TATE      
HUNT       : YANG       WEEKS      ROBLES     RICK       KRYSTAL   
BETH       : MCFADDEN   NORMA      MAYNARD   
RENA       : CLEMENTS   BOWERS     THOMPSON   SUSAN      LELIA      REYNOLDS  
ROBERTSON  : BARRY      FRYE       PETTY      BUDDY     
KEVIN      : JANELLE    KATHLEEN   NEIL       ALEXANDRA  COTE      
KRYSTAL    : LILIANA    MCCARTHY   GARRETT    HINES      ROSS       ROJAS      HUNT      
WELDON     : GOODMAN    KYLE      
ESTRADA    : COOLEY     ERIK       HOOD       MAYNARD   
GREENE     : ANTONIO   
MCMAHON    : PAMELA     IGNACIO    BERNADETTE MARCELO   
TRENT      : PHILIP     SCHULTZ    HERMINIA   GILLESPIE  COFFEY    
REGINA     : MARISOL    BRADLY     WHITFIELD  NEWTON     BOBBI      JAMAR     
POLLARD    : LEE        FRANCISCO 
QUINTON    : RAMIRO     DEMETRIUS  TERRENCE  
CAROLE     : PHILLIPS  
HOLLAND    : ESTES      NICOLAS    BRANDY     BUTLER     BURRIS    
KERR       : JOANNA     MOLINA     MAURICE   
DARRYL     : JOYCE      BARKER     PARRISH    DAVID      CONSTANCE 
CHARLES    : SETH       MATHIS    
LOGAN      : DORIS      RAPHAEL   
CASSIE     : HERBERT    LUCIANO    ROCKY      ASHLEE     CHERRY    
BOWEN      : GLENN      NORMA     
HARPER     : FREDERICK  SALVATORE 
FRANKLIN   : BETTE      AMELIA     LETICIA    CAMERON    JACOBS    
WONG       : WOLF       KERRY      FLEMING    TEDDY     
MERRILL    : TAMERA     WEEKS      ALISSA     SHELLEY   
MONA       : CASANDRA   ERIK       MADDEN    
TONIA      : VELASQUEZ  ELMA       JACLYN     COOLEY     BURTON     CLARA      MCCARTY    ETHEL     
DANA       : PHOEBE     DUNN       WENDY      THADDEUS  
ANNABELLE  : CLARK      WOLF       ROCCO      TATE       COLLEEN    SIMPSON   
TY         : REEVES     DEAN      
HILL       : HENDERSON  VALENZUELA
BAUER      : ROTH      
TRACY      : SILAS      JAIME     
HAYDEN     : TAMMI      VEGA       VALENCIA   NELDA     
NATASHA    : LOTTIE     BEASLEY   
RAUL       : WARD       DELANEY    SYKES     
VAUGHN     : ANIBAL     MARIA      SCHNEIDER  FARLEY     LEVINE     GUTHRIE    ISABELLA  
LORAINE    : MILLICENT  CASANDRA   RAYMOND    DAVID      KRISTINE  
RACHAEL    : JULIO      KASEY     
SHERRI     : MAVIS      NORRIS     AURELIA    GENEVA     SANTANA   
PETERSEN   : CONNER     TRAN      
