OLGA       : BARRERA    ROSARIO    NANCY     
ROB        : WEBER      COLLEEN    MERLE      KRISTINE   ALINE     
DORIS      : STACIE     NORMA      HEWITT     RANDOLPH  
WILLARD    : NUNEZ      BOWERS     ANNMARIE   MARCUS     SAVANNAH   HOLLAND   
COLON      : COLLIER    HUBER      GILLESPIE  PASQUALE   KRYSTAL   
MAVIS      : DINO       WILFREDO   PAULETTE   POPE       MARGERY    JARED      REGGIE     TRAVIS    
LANDON     : MERCADO    TONI      
KATHERINE  : AMELIA     DAPHNE     JUAREZ     MCCRAY     GRAY      
PAGE       : BELL       BARRERA    MERRITT    WASHINGTON
HOOPER     : CASTILLO   DAPHNE     FREDERICK  DUNLAP     SHELLEY   
OLIVER     : CHARITY    MACIAS    
CASTILLO   : HOOPER     BONNER    
TRENTON    : ROSETTA    JESSIE     GINGER     OTTO       ALBERT     ESTRADA   
RAMSEY     : VONDA      CHRISTA    DONA       CHERI      HICKS      KEITH      MOSLEY    
VILMA      : LATONYA    LEACH      BOYER      JESSICA   
MCDONALD   : KATY       TODD       VONDA      RODRIQUEZ 
PEARSON    : BLACKWELL  GIOVANNI   DELACRUZ   INA       
WALTON     : BOBBIE     MARA       CALLAHAN   WENDY      CORINNE    HUDSON    
CARLSON    : VERA       BENNIE     DELANEY    ROWE       JOHNSTON  
MARISOL    : DIONNE     SAMUEL     HENRY      NOEL      
LESTER     : ANDERSON   DUNN       FLETCHER   JAIME      JULIO      CEDRIC     DUNCAN     CASTRO    
LESTER     : LESSIE    
MANN       : TYREE      CLARENCE  
PERRY      : CLEMENTS   WALSH      RODGERS    INGRAM     JULIET     STEVENSON 
KATY       : MCDONALD   GARRY      HUGH       KEVEN      WILLIAMS  
MARK       : CANDICE    HANSON     HOLMAN     BENTON     TY        
ANTONE     : DEWAYNE    FREDDIE    AL         MARGARITO 
JOHN       : REEVES     CECELIA    RUSS       MERLE      RANDOLPH  
MAXWELL    : CAITLIN    LES       
ANNA       : SANTIAGO   KURT       ROMAN      FREDERICK  DANIAL     DUFFY      RUSSO     
LETITIA    : EMORY      ANITA      GEORGE     NIKKI      LORAINE   
VALERIE    : ROSALIE    NOE        LOTTIE     VICTOR     ALEXANDRA  STANLEY   
MCKAY      : VICTORIA   SHEPHERD  
PRINCE     : DUSTY      SONYA      SHEPHERD  
LUCIEN     : MARIBEL    MOLINA     EMILY      STANTON   
CHANEY     : FAULKNER   RICK      
GILMORE    : BENJAMIN   WILLIS     GIBSON    
LESLIE     : ELLIS      FULTON     ISIDRO     JOSH       GLOVER    
MARION     : FULTON     AVERY      RICK      
GLENN      : DELGADO    COFFEY    
LEE        : GARRETT    DICK       LEMUEL     BERNADINE 
HATFIELD   : CHRISTI    DEANA      CAROLYN   
CRYSTAL    : CECELIA    COOLEY     ANDREWS    WOODARD    PHILLIP   
LUCILLE    : TASHA      SERRANO    ELIJAH    
PATE       : GRACE      HARRIS    
MONICA     : JULIA      HERRING    HARRIET    KANE      
LENARD     : LANA       STUART     BETTE      CAROLINE   ALYSON     GALLAGHER 
RAMIRO     : JIMENEZ    SUSAN      DURAN     
PHOEBE     : JAMAAL     BARRERA    DANIELLE   ROSALINDA  HELENA    
FOX        : CRAFT      LINDSAY    GLORIA     TRUDY     
ROBERTA    : BYRD       RICARDO    MOHAMED   
BENJAMIN   : GILMORE    DARRELL    ERIKA      MATHIS     CAIN      
LEONOR     : DARIN     
TILLMAN    : ALBA       STOUT      GINGER    
AVIS       : SAM        WYATT      CHELSEA    JODIE      LUCAS      CAROL      JOHNSON   
ANDERSON   : LESTER     DAVID      BOBBI      DARIN     
JENNINGS   : DOMINGO    HUDSON     TRAVIS    
LATONYA    : VILMA      DODSON     MILDRED    DIXON     
ODESSA     : MANNING    HELGA     
LILIANA    : FANNIE     GONZALO   
LITTLE     : STRICKLAND SUAREZ     JESSICA   
MADELINE   : MENDOZA    TRUDY      MUNOZ     
PERCY      : COOK       MILLIE    
WARD       : ARIEL      JESSIE     ERMA      
KNOX       : MCCARTHY   CARISSA    DAWN      
FIELDS     : ALFONZO    SYKES      HUMBERTO  
AMIE       : JANELLE    CALLAHAN   VALENZUELA
WITT       : ROSALINDA  RUSSEL     MARTIN    
CANDICE    : MARK       MILAGROS   FREDRIC    WISE       RODERICK  
MONTGOMERY : BELL       CHRISTA    WEAVER     ROD       
JANELLE    : AMIE       EUGENIA    TINA      
HOLDEN     : HERIBERTO  TORRES     CURRY      LACEY      INA       
DERICK     : COMBS      FORBES     CAMERON    DONALD    
MEREDITH   : MCCULLOUGH ASHLEY    
WALTERS    : BARLOW     HIRAM      WEBER      WEISS      TABATHA    JORDAN     TATE      
ABE        : TRAN       ERMA       REINALDO  
JACKIE     : SANTIAGO   LANGLEY    MERRITT    CONSTANCE 
COPELAND   : WILL       RONNY     
ESTES      : CARROLL    TORRES     ONEIL     
HERRERA    : REBEKAH    HERSCHEL   CEDRIC    
THELMA     : JILL       ADELINE    TAMMIE     HAWKINS   
MILAGROS   : CANDICE    CORY       INGRAM     PASQUALE  
ARIEL      : WARD       REBEKAH    GARTH      AUSTIN     DENIS      BILLIE    
MERCADO    : LANDON     WILCOX     FLETCHER   KLINE      THURMAN    ZAMORA     GLORIA     GUZMAN    
MERCADO    : LEMUEL     RUSSO     
MCNEIL     : RAMOS      MCINTYRE   HOMER      SANFORD    CORRINE   
SIMON      : CORY       VASQUEZ    LYMAN      OTIS       DELACRUZ  
TODD       : MCDONALD   FLETCHER   HOLT       MERLE      MORROW     BARR       LLOYD     
MARCELINO  : FERDINAND  STACY     
WILCOX     : MERCADO    FLORINE    TRAVIS     ANNABELLE 
LEACH      : VILMA      WOODWARD   CINDY      ENID       ELINOR     RUSSEL    
IRIS       : ANIBAL     MCFADDEN   ARNULFO    CARVER    
INES       : FERNANDEZ  LEVINE     BOLTON    
WEBSTER    : STACIE     HART       RICHARD    TAMMI      MARA       GENARO     EVANGELINE
RAMOS      : MCNEIL     JOHANNA    CARSON     AL         GABRIELA   PUGH      
BLACKWELL  : PEARSON    BLEVINS    JARVIS     DARYL      GUY        HICKS     
ANIBAL     : IRIS       MARGARITA  LANGLEY    IGNACIO    GIBSON     HAWKINS   
DONOVAN    : MERCEDES   DANIEL     HILL      
LILA       : HIGGINS    WINFRED   
HOBBS      : NIKKI      SONNY      LEON      
STACIE     : DORIS      WEBSTER    JONI       TAMMY      DUKE      
CHRISTI    : HATFIELD   AMANDA     BRUCE      LENORA    
LOIS       : WILKERSON 
JAMAAL     : PHOEBE     CLARK      GOODMAN   
BALDWIN    : PAULETTE  
MONTY      : TYREE      LORRAINE   SNOW      
HARRINGTON : GEORGE     HOUSE      CROSBY    
PICKETT    : ALTA       MARGERY   
EUGENIA    : JANELLE    EDMUND     MARTINEZ   COX       
SAM        : AVIS       MAC        BETTE      STEVEN     MONA      
OCTAVIO    : HENSLEY    LAMBERT    LANCASTER  NEIL      
HAMILTON   : WASHINGTON
CRISTINA   : DINO       ROBBY      TOM        HUBER      MUELLER   
BRENDAN    : WYATT      BORIS      BUDDY     
BARRY      : HORTON     JOSUE      PARKS      TRENT     
WARREN     : DARRELL    LYMAN     
HANNAH     : CAROLYN    DOROTHEA   BARKER     ROWE      
ERIN       : CAMERON    SANTANA    BURKS     
HOUSTON    : REYNA      PRUITT     ADELINE    STEWART    SAMPSON    JOHNSON   
BELL       : PAGE       MONTGOMERY RACHAEL   
SWEET      : BORIS      TONI       ESTELLA   
BARLOW     : WALTERS    EMORY      TERRY     
DUNN       : LESTER     LARSEN     SWANSON   
LANA       : LENARD     VELMA      CAMACHO   
YANG       : JASPER     NANNIE     DECKER     JULIE      ROYCE     
ANDY       : FISCHER    SELENA     BOWERS     ALICIA    
HIRAM      : WALTERS    GILBERT    HURLEY     MURIEL     SANCHEZ   
CONNIE     : ODELL      DUSTY      MURIEL    
BARNES     : WEEKS      RICHARDS   BOB        KIDD      
JEFFERSON  : ETTA       WALSH      DON       
PAMELA     : WILL       ARNULFO    SARGENT    HARRISON   NAVARRO   
MERCEDES   : DONOVAN    REYES      SOFIA      GALLOWAY   LINDSEY   
HORTON     : BARRY      JEREMY    
HERBERT    : BURT       LEONARDO   LORENZO    DELGADO    JIM       
BARRERA    : OLGA       PAGE       PHOEBE     KATHY      KEITH      KRAMER    
MCCONNELL  : LOURDES    WILBUR     MILLS     
ROSALIE    : VALERIE    ROCCO      MILO      
CHARLOTTE  : HENRIETTA  FERN       MILLS      YVETTE    
JILL       : THELMA     MAGGIE     DUSTY      NOELLE     RYAN      
MAC        : SAM        JARVIS     MAGGIE     BALLARD    VICKI      GOODWIN   
WALDO      : MILES      LORRAINE   OLSEN      CHARMAINE 
LEVI       : WOODWARD   ERNESTINE  JANICE     BUCKLEY    ALFRED     PETERSON   PETERSEN  
WARNER     : ALICIA     BENTON    
HARRELL    : RICE       SELENA     ALICIA    
GOMEZ      : KRISTINE  
SOTO       : ERICK      BROWN      DONALD     VAN       
ABRAHAM    : LORRAINE   HARMON     JIM        JOYNER     BARTON    
JIMENEZ    : RAMIRO     HUNTER     JACLYN     STEVENSON 
ALLISON    : TATE       CANDY     
BUCKNER    : GILBERT    PITTMAN    CUNNINGHAM MURIEL     REGGIE    
FREDERIC   : CASE       BUDDY      ORR        ISIAH     
COMBS      : DERICK     REYES      VERN       MASSEY     TYLER     
DODSON     : LATONYA   
REBEKAH    : HERRERA    ARIEL     
ROSETTA    : TRENTON    ODELL      GRIMES     MICHEAL    FRANCES    MCCARTY    MACDONALD 
HARDY      : RODNEY     CECELIA    CECIL      NOE        CURRY      LOGAN     
VELASQUEZ  : FANNIE     MCCULLOUGH LYNN       CAROLE    
WEBER      : ROB        WALTERS    BYRD       BRANDY     ROSARIO   
BAIRD      : DEENA      WHITAKER   WHITLEY    SIMS      
ALEXANDER  : ELISEO     WILFORD   
BRYON      : CONNER     VICKI      AUBREY    
MARGARITA  : ANIBAL     GRIMES     CARISSA    JIMMIE     WENDY      SIMPSON    KANE      
OCONNOR    : ROWE       MOSLEY    
ALVIN      : BURTON     ROBT       JEAN       SHANNON   
FOREST     : DEWAYNE    DEWITT     BARTON    
CHARITY    : OLIVER     DIANE      ED        
COOKE      : WELCH      BRANDY    
DIONNE     : MARISOL    EMORY      LANE       HERIBERTO  MARCEL    
TRICIA     : MAGGIE     SUSAN      RYAN      
VERA       : CARLSON    PHILLIPS   BENNIE     WILBUR     TRUDY      JACKSON   
NUNEZ      : WILLARD    GLADYS     IAN        LEONARD    DIXIE      MORROW     DARIN     
ALBA       : TILLMAN    MICAH      CORY       SHANA      SOLIS      DAWN       GLORIA     FAULKNER  
ISSAC      : GRIFFIN    PACHECO    JUAREZ     SYKES      HEWITT     LAWANDA    BAUER     
FLOSSIE    : WELLS     
ELMA       : GONZALO    DALE       AURORA    
BLEVINS    : BLACKWELL  SNOW       JACOBS     WILLIE     LENORA     MONA      
BUCK       : LETICIA    GLOVER    
NICOLE     : MALLORY    BENITO     WENDY      JOSE      
MCMILLAN   : WINTERS    HINES      MALLORY    AURORA    
REEVES     : JOHN       MARIA      ENGLAND    EDITH      ARMSTRONG  CLARA      ASHLEE     TERRELL   
BYRD       : ROBERTA    WEBER      CASANDRA   MCCARTY   
MOSES      : VICTOR     STEVEN     AHMED      BURRIS    
IRWIN      : KRISTIE    ART        MORROW    
CAITLIN    : MAXWELL    BRIGITTE   ESMERALDA  AUBREY    
STEPHENS   : CLEMENTS   CROSS      CRAIG      KNIGHT     RAUL      
SYDNEY     : ERICK      LOTTIE     NOEL       REGINA    
DINO       : MAVIS      CRISTINA   HINTON     MARISSA   
CLEMENTS   : PERRY      STEPHENS   TYREE      AURELIA    WALLER    
MCCARTHY   : KNOX       DALE       GARZA      BEASLEY    CASSIE     LORAINE    PETERSEN  
OSCAR      : ALTA       GARZA      POLLARD   
GRIFFIN    : ISSAC      SHEPHERD  
LUNA       : CHARLIE    BARBER     DELGADO    BENITO     MERCER    
MCKEE      : TUCKER     DAPHNE     FREDRIC   
IVANA      : KERRY      GRETA      BOLTON     AISHA     
BAKER      : SHERYL     CAMACHO    ARTHUR     BARNETT    CASSIE    
DEENA      : BAIRD      CLEVELAND  JANICE     GOOD      
WINTERS    : MCMILLAN   TANIA     
EMORY      : LETITIA    BARLOW     DIONNE     NEWMAN     WALLS      VERNON     JEWELL     COTE      
EMORY      : PARKS     
ROBBIE     : WILKINSON  RAUL      
WEISS      : WALTERS   
LAUREN     : CRANE      CAMERON    ALBERTO    REGINA    
ODELL      : CONNIE     ROSETTA    ANDREWS    ENGLISH   
KNOWLES    : KURT       DELGADO    WHITE      MCMAHON   
ROBBY      : CRISTINA   RODNEY     PRUITT     FOSTER     TERRENCE  
STUART     : LENARD     MASSEY    
OLA        : JULIA      GREGORY    LEONEL     ADDIE     
GARTH      : ARIEL      MCCULLOUGH CORINNE    GATES     
BEAN       : EFREN      BARR      
ANITA      : LETITIA    HIGGINS    JEWELL     CHRISTIAN  WASHINGTON DYLAN     
VELMA      : LANA       HUGHES     DAREN      DYLAN     
KRISTIE    : IRWIN      WENDY      THADDEUS  
ARRON      : MICHEAL   
JOHANNA    : RAMOS      BURGESS    ANDREA     EVERETT    GARNER    
BETTE      : LENARD     SAM        LANCASTER  MCINTYRE   BETH      
ROBINSON   : WILL       DONNY      MARCI      CONSTANCE  CASSIE    
TABATHA    : WALTERS    GILES      COTE      
GRIMES     : ROSETTA    MARGARITA  DEJESUS    STRICKLAND KOCH       COTTON     MITCHELL  
DARNELL    : LAMBERT    TERRI      WALL      
GILBERT    : HIRAM      BUCKNER    HARRISON   BASIL      SCHWARTZ   HELENA    
PITTS      : DELORIS    ANTONIO    GALLOWAY  
SANTIAGO   : ANNA       JACKIE     TAYLOR     PALMER    
CLAYTON    : FRANCESCA  PAT        SIMPSON    JAY        FUENTES   
GARRETT    : LEE        ROXANNE    LANG       JOSEPHINE  NATASHA   
MARIA      : REEVES     BEST       LAUREL    
FISCHER    : ANDY       ROCKY      MALLORY   
CARNEY     : ANNIE      ANNMARIE  
DILLON     : TOWNSEND   EARLE      JAMEL      HOLLAND   
CASE       : FREDERIC   HENDERSON  DEANNE     GILLESPIE  RONNY     
PITTMAN    : BUCKNER    NIKKI      JARED      LUISA      BLAKE      STEPHENSON
SCHNEIDER  : MCLEOD     BRIAN      MARYANNE   PETTY     
WYATT      : AVIS       BRENDAN    MARCUS    
MCLEOD     : SCHNEIDER  CATHRYN    LAURI     
MCLAUGHLIN : KIM        JOSEPH     PRISCILLA  DURAN     
WELCH      : COOKE      ELDON     
MCKENZIE   : CAROLINE   GILES      GALLOWAY   FINLEY    
HART       : WEBSTER    HEIDI      SOFIA      FERRELL   
SPENCE     : LYMAN      KURT       ROOSEVELT  DEWITT    
PENNINGTON : WILBUR     LACEY     
JOHNS      : WOODWARD   JACOBS     OBRIEN    
HANSON     : MARK       ALVAREZ   
NOLAN      : DEJESUS    CARSON     MANUEL     ERNESTINE  VALENTINE 
DEJESUS    : GRIMES     NOLAN      RODGERS    SUSAN      DAVID     
BURT       : HERBERT   
HUNTER     : JIMENEZ    FLOYD      HOLT       DIXIE     
MICAH      : ALBA       BRUCE      BRUNO      NEWTON     FERDINAND  HOLLOWAY   SHELLEY   
FANNIE     : LILIANA    VELASQUEZ  MARCUS     LORIE      LARSON     IRA       
CORY       : MILAGROS   SIMON      ALBA       ISABELLE  
REYES      : MERCEDES   COMBS      RICARDO    TIMMY      CAROLINE   COLLIN    
URSULA     : KENNEDY   
JARVIS     : BLACKWELL  MAC        JODIE      CHERI      ANTONIO    CLARENCE   POOLE     
JUSTINE    : HOPKINS    MCINTYRE   MCCARTY   
MARIBEL    : LUCIEN     ERICK      BROWN      MONA      
RODNEY     : HARDY      ROBBY      LEWIS      CLAUDIA   
HEBERT     : CARSON     NORRIS     WOODARD    LINDSEY   
SILVA      : CHERRY     NELDA     
JACLYN     : JIMENEZ    FRANKS     RITA       MARVIN    
PHILLIPS   : VERA       DAVENPORT  VARGAS     ROTH       POLLARD   
TOBY       : SAUNDERS  
GONZALEZ   : CRANE      STEVENSON 
ELLIS      : LESLIE     ANNETTE    JOHNSTON  
CHARLIE    : LUNA       TARA       MARIANO    CLEMONS    BAUER     
HOLMAN     : MARK       KERR      
EDMUND     : EUGENIA    TUCKER     MCCARTY   
FRY        : VICTORIA   SEBASTIAN  MARCUS     AYALA     
CARSON     : RAMOS      NOLAN      HEBERT     LINDSEY   
HUGHES     : VELMA      STEFANIE   FAITH      JOYNER    
BURGESS    : JOHANNA    TASHA      LUCIANO    TAMMI      CORRINE   
AUSTIN     : ARIEL      ERMA       GALLOWAY  
PIERCE     : MARCUS     JEREMY     TRENT     
DENIS      : ARIEL      LEONARDO   DAWN       RANDOLPH   ANGIE     
CHANG      : LEANNE     STRICKLAND ANASTASIA  CARLA     
HINES      : MCMILLAN   LEWIS      GIBBS     
TRACEY     : SUZETTE    JARED      TAMMIE     KENTON     WENDI     
DARYL      : BLACKWELL  FRIEDA    
DIAZ       : BALLARD    CONRAD     GILBERTO  
CECELIA    : JOHN       CRYSTAL    HARDY      KENNEDY    REUBEN     SERGIO     PATSY      BASIL     
LARSEN     : DUNN       GILLESPIE 
RICE       : HARRELL    FREEMAN    ELBERT    
BRIAN      : SCHNEIDER  ENID       LYNN       MERRILL   
JOHNATHAN  : JERALD     PUCKETT    HURST      ERNIE      DANA      
BENNIE     : CARLSON    VERA      
ERICK      : SOTO       SYDNEY     MARIBEL    GERARDO    FLYNN      BAUER     
LEANNE     : CHANG      NICOLAS    BEST       BUCHANAN   COLEMAN   
KENT       : CURRY      RENA      
COOLEY     : CRYSTAL    SAMUEL     JARROD     PETERSEN  
TASHA      : LUCILLE    BURGESS    ELOISE     NORMA     
BERT       : FLORES     RONALD     STACI      GENARO     CORRINE   
GUY        : BLACKWELL  MARIANA    DELANEY    PARRISH    CONSTANCE  COLLINS   
CLARK      : JAMAAL     AYALA      ROWE      
TUCKER     : MCKEE      EDMUND     TOM        MILLER     SIMONE     FRANCISCO 
VONDA      : RAMSEY     MCDONALD   THOMPSON   FRANCES   
FROST      : WHITFIELD  ANGELITA   ROBERTSON 
NORTON     : CANTU      EDWIN     
CRAFT      : FOX        MABEL      KENTON     RUSSEL    
LYDIA      : KLINE      GARNER     COTTON     DANA      
FRYE       : FLETCHER   HENRIETTA  QUINTON   
SELENA     : ANDY       HARRELL    PAM        ALISSA    
BRIDGETTE  : BRIANA     WILLIAMS   SOLOMON    NIEVES     LEON      
WOLF       : AGNES      HENDRIX    BENTLEY    WILLIE    
THOMAS     : MARIE      BRADLY     DELORIS    NOEL      
YOUNG      : CARLENE    BEST       SHERYL     ROSARIO   
DEANDRE    : NORRIS     LAUREL     BATTLE    
KIM        : MCLAUGHLIN LEONARDO   RUSSELL    HECTOR    
ENGLAND    : REEVES     SUSIE      SCHWARTZ  
CHELSEA    : AVIS       COLLIER    BARKER     OBRIEN    
AGNES      : WOLF       KERI       WATTS     
SILAS      : CAROLINE   SOSA       CARDENAS   THADDEUS   TABITHA    PHELPS     BARTON    
MAGGIE     : JILL       MAC        TRICIA     KERI       ROWE      
HIGGINS    : LILA       ANITA      KATHLEEN   SHEPARD    WATERS     BLAIR      GLOVER    
TYREE      : MANN       MONTY      CLEMENTS   CINDY      FERDINAND  LE        
ELOISE     : TASHA      ROBT       HICKS      TRAN       ADDIE      ANGELITA  
TOM        : CRISTINA   TUCKER     AMANDA     VASQUEZ    LUISA     
MARGUERITE : MARA       PAT        LEON       BLAKE     
DEWAYNE    : ANTONE     FOREST     HINTON     RITA       SHAWN      GINGER     ETHEL     
FLOYD      : HUNTER     RICHARDS   TREVINO   
RICHARD    : WEBSTER   
EDITH      : REEVES    
WHITAKER   : BAIRD      TONI      
ANNIE      : CARNEY     CATHRYN    WILKERSON 
FLETCHER   : LESTER     MERCADO    TODD       FRYE       FOWLER     JOSE       GAY       
CHRISTA    : RAMSEY     MONTGOMERY GARNER     RACHAEL   
LEONARDO   : HERBERT    DENIS      KIM        ART       
LANGLEY    : JACKIE     ANIBAL     PARK       HERIBERTO  PRESTON   
STEFANIE   : HUGHES     HERSCHEL   SUSIE      DANIAL    
STEELE     : CRANE      ALFRED     MONROE    
BARTLETT   : JERALD     BERNADETTE ALINE     
KLINE      : MERCADO    LYDIA      CUNNINGHAM CHERI      WINFRED   
KRISTOPHER : MICHEAL    SCOTTIE    CHARMAINE 
ETTA       : JEFFERSON  BRANDY     BRIGITTE   MAE        COMPTON    FERDINAND  GIBBS     
ISABELLE   : CORY       DWIGHT     MARCIA     DANA      
AMELIA     : KATHERINE  RUSSELL    STEVENS    KAUFMAN    BERNARDO  
TARA       : CHARLIE    MCCORMICK  HURST     
ALTON      : JOY        LEWIS      LUCAS      FAITH     
BALLARD    : MAC        DIAZ       OLSON      ROSALES    GIBBS     
ROMERO     : ALFREDA    DUSTY      LEVINE     DEANNE    
RIVERA     : TREVINO    RUSS      
JOY        : ALTON      MILLIE    
ALTA       : PICKETT    OSCAR      POTTS      NORRIS     STEPHENSON
MARIE      : THOMAS     HOLT       NICHOLSON 
MCCULLOUGH : MEREDITH   VELASQUEZ  GARTH      RICO       HERMINIA   JANINE     RICHARDSON
SEARS      : FERRELL   
NEWMAN     : EMORY      MAYS       BOWMAN    
JODIE      : AVIS       JARVIS     MILDRED    MAYER     
JAIME      : LESTER     BRIGHT     NADINE     TRACY     
BROCK      : GREGORY    JUANITA    HERMAN     SUSIE      GALLAGHER  SHELLEY   
SLOAN      : EVERETT   
NICOLAS    : LEANNE     KIDD       ALFRED    
HENSON     : ERNA      
CLAUDETTE  : FRANCES    ALBERTO    CANDY     
MILLICENT  : DAPHNE     BEACH      NORRIS     SANTANA    RICK      
RIOS       : BORIS      HEATH      ROBLES     NANETTE   
XAVIER     : BERGER     WEAVER     EVANGELINA CURRY     
CONLEY     : SALAZAR    MARGARITO  BILLIE     CAROLE    
ROSE       : STEVENS    LORENA     BILLIE     BASIL     
MARYANNE   : SCHNEIDER  MARGERY    GALLOWAY  
DAVIS      : REYNA      SUZETTE    LEMUEL    
POTTS      : ALTA       SONYA      VERNON     MARKS      HUFFMAN   
MEDINA     : AYALA      PETERSEN  
WIGGINS    : BRIGHT     INGRID     ROBBINS    ALFRED     MACK       CORRINE   
BRANDY     : WEBER      COOKE      ETTA       NICHOLS    HAZEL     
BERTIE     : HICKS      MENDOZA    EVE       
BRIGHT     : JAIME      WIGGINS    DOYLE      STARK     
FRANKS     : JACLYN     PHILLIP    CROSBY    
FORBES     : DERICK     JAYNE      VAN       
MARY       : NOE        HANEY      PAULETTE   LELIA     
CARLENE    : YOUNG      HINTON     SAVANNAH   FRANCISCO 
HARVEY     : TREY       NETTIE     SETH       KYLE      
MILLER     : TUCKER     ALFONZO    NOEMI      PETERSEN  
DARRELL    : BENJAMIN   WARREN     ADAM       GOOD       PHILLIP   
FEDERICO   : WHITFIELD  LORIE      CHRISTIAN  HODGE     
LEWIS      : RODNEY     HINES      ALTON      TAMMY     
CECIL      : HARDY      FRANCES    WEBB      
RICO       : MCCULLOUGH QUINCY     OLSON      GRAHAM    
LUCIANO    : BURGESS    JANINE     ANNETTE    TONI       DUFFY     
FRIEDA     : DARYL      GLASS      OBRIEN    
PETTY      : SCHNEIDER  WOODWARD   ROBT       FRANKLIN  
TAYLOR     : SANTIAGO  
ERIKA      : BENJAMIN   DENNIS     RICK       ANDREW    
WILFREDO   : MAVIS     
STRICKLAND : LITTLE     GRIMES     CHANG      GUZMAN    
CASANDRA   : BYRD       SERRANO   
FREDDIE    : ANTONE     GLORIA     HUBBARD   
ISRAEL     : JANICE     HELENA     BOWEN     
AMANDA     : CHRISTI    TOM        FULTON    
MOLLIE     : CHANDLER   PAT        JAY       
GILL       : ELVIRA     BLANCHARD  BURRIS     RANDOLPH  
BONITA     : ANTONIO    REFUGIO    PHILLIP    WENDI      LEON      
GARRY      : KATY       WOODWARD   LORI       SHIRLEY    LORIE      CHARLENE  
JORDAN     : WALTERS    WEAVER     BLANCHARD  MENDOZA    HELGA     
KATHY      : BARRERA    REESE      CRAIG     
DAPHNE     : KATHERINE  HOOPER     MCKEE      MILLICENT  AURORA     RACHAEL   
WALSH      : PERRY      JEFFERSON  CUNNINGHAM ROBLES     TORRES     DAMON     
ANDREA     : JOHANNA    ISIAH      CALVIN    
TAMERA     : HENDERSON  BRADSHAW  
NOE        : VALERIE    HARDY      MARY       CURRY     
GIOVANNI   : PEARSON    WILKINSON  PRESTON    HELENA    
WILL       : COPELAND   PAMELA     ROBINSON   MAE        ALEXANDRA  HARRISON  
JOYCE      : MAYNARD    RUSSO     
WHITLEY    : BAIRD      STEWART    ESTRADA   
WEEKS      : BARNES     DIXON      MARCIA    
HILARIO    : PAM        SHARRON    LINDSEY    TYLER     
CHAN       : NOELLE     CALLAHAN   BARBER     HUMBERTO   BULLOCK    HEAD       STANLEY   
BEST       : MARIA      LEANNE     YOUNG      FOSTER     BOWEN     
FLORES     : BERT       DECKER     ERICKSON   INA       
JOANNA     : MARTINEZ   MARTHA     JIM       
DONNY      : ROBINSON   ROSARIO   
BRADLY     : THOMAS     JIMMIE     ROD        CALVIN    
BUTLER     : ART        RICHMOND  
VASQUEZ    : SIMON      TOM        RANDALL    ANDREW    
NICHOLS    : BRANDY     RASMUSSEN  NANCY      OLSON      JULIAN    
KERRY      : IVANA      BOBBI      HOOD      
BORIS      : BRENDAN    SWEET      RIOS       BOBBIE     KELLEY    
VICKY      : GINGER     BRUCE      LLOYD     
COOK       : PERCY      HOLDER     ORTIZ      RANDOLPH  
ROY        : LES        LUPE       IAN        HARMON     VALENZUELA TURNER    
BOWERS     : WILLARD    ANDY       MARSH      TERRENCE   CAROLE    
HEATH      : RIOS       CARMELO    CHERRY     ENID       FERRELL   
STOUT      : TILLMAN    CONTRERAS  JUANITA    SHERMAN    ROBERT    
CLYDE      : NITA       ANTONIO    HENDRICKS 
DANIELLE   : PHOEBE     SUSAN      NEIL      
PHILIP     : NORA       VALENZUELA
HANEY      : MARY       BLANCHARD  AHMED     
RUTLEDGE   : DOYLE      GREGORY    GEORGIA   
DONA       : RAMSEY     AVERY      JAYNE      ERNIE      CUMMINGS   SALVATORE 
LOURDES    : MCCONNELL  HAYS       BRADSHAW   MILDRED   
MCFADDEN   : IRIS       DENA       LINDA      NOEL      
TIMOTHY    : LORENZO    BRAY       MARISSA    PHELPS    
DIANE      : CHARITY    COLEMAN    CAIN      
NEAL       : BOB        ELIJAH     ESTELLA    FINLEY    
KATHARINE  : ALVAREZ    SIMS       SARGENT   
KRISTINA   : KRAMER    
BOBBIE     : WALTON     BORIS      MCCALL     DENA       AUBREY     KELLY     
MANUEL     : NOLAN      DAVENPORT  FINLEY    
ANNMARIE   : WILLARD    CARNEY     JESSE      BRADLEY   
SCOTT      : LULU       KELLEY     STANTON    ALI       
PECK       : CLINT      FRANKLIN  
CANTRELL   : MONTOYA    TONI       STRONG    
JULIO      : LESTER     SAUNDERS   CROSBY     BRIDGET   
ABEL       : MILES      MCCALL     CARROLL    WILLIE    
ROCCO      : ROSALIE    CARR       DYLAN     
FIGUEROA   : ROMAN     
JULIA      : MONICA     OLA        WENDY     
HENSLEY    : OCTAVIO    CLARA      ANNETTE    SAMPSON    AUBREY     DWIGHT    
ROXANNE    : GARRETT    MILES      BUCKLEY    ELVA      
BURTON     : ALVIN      FERN       MARCY      JOSE      
GLADYS     : NUNEZ      ALBERTO   
SIDNEY     : SIMONE     ALYSON    
WOODWARD   : LEACH      LEVI       JOHNS      PETTY      GARRY      EVANGELINA
LAMBERT    : OCTAVIO    DARNELL    FERNANDEZ  MILLS     
DEANA      : HATFIELD   MARYELLEN  QUINCY     BUCHANAN   MOODY      TANYA      JAMEL     
CAROLYN    : HATFIELD   HANNAH     HULL       SERRANO    HECTOR     ARNULFO    SONNY      JAMAR     
CUNNINGHAM : BUCKNER    KLINE      WALSH     
SARA       : ROBLES     COLLEEN    CUMMINGS   BARBRA    
KERI       : AGNES      MAGGIE     LYMAN      TATE       HELGA     
GONZALO    : LILIANA    ELMA       MORRIS     TIMMY      MEADOWS   
DOYLE      : BRIGHT     RUTLEDGE   IGNACIO    ROJAS      WINFRED   
ADAM       : DARRELL    NOELLE     KIP        BARBER     KENDRA     FRANKIE    BRYAN      WEBB      
IGNACIO    : ANIBAL     DOYLE      CLAUDIA   
GREGORY    : OLA        BROCK      RUTLEDGE   THURMAN    DEMETRIUS 
WOLFE      : MARTINEZ   MARISSA   
MILES      : WALDO      ABEL       ROXANNE    HOLDER     ALICIA     SOFIA     
HORN       : MEADOWS    PAYNE      ESTRADA   
MORRIS     : GONZALO    BRIANA     CALVIN     MADDEN    
STARK      : BRIGHT     VICTOR     NEWTON    
LORENZO    : HERBERT    TIMOTHY    KARYN      RODGERS    KOCH       MALLORY   
KENNEDY    : URSULA     CECELIA    RASMUSSEN  JOSUE      ANDREW     MCCLURE   
ROBLES     : RIOS       WALSH      SARA       ALYSON     CASTRO    
LEBLANC    : CHANDLER   RONNY      WHITE     
REUBEN     : CECELIA    CONRAD     MICHAEL   
LYMAN      : SIMON      WARREN     SPENCE     KERI      
DALE       : ELMA       MCCARTHY   SAMUEL     SALAZAR    WISE       WILLIAMS  
DARCY      : JAMAR      POLLARD   
SERGIO     : CECELIA    ELIJAH     CASTRO     ALINE     
DONNA      : PRISCILLA  JAMAR     
ENRIQUE    : FERN       JERALD     SIMONE     CHERRY    
SHERYL     : BAKER      YOUNG      MATHIS     LENORA     MOSLEY    
MARTINEZ   : EUGENIA    JOANNA     WOLFE      GARZA      WILBUR     KYLE      
ART        : IRWIN      LEONARDO   BUTLER     KOCH       NIEVES     HENDRICKS  JAMAR      DANA      
LOTTIE     : VALERIE    SYDNEY     EARL       JACOBS     ONEIL     
CHERI      : RAMSEY     JARVIS     KLINE      WEAVER    
COLLIER    : COLON      CHELSEA    MERLIN     RODRIQUEZ 
HINTON     : DINO       DEWAYNE    CARLENE    KRISTEN    HUFFMAN    MINNIE    
HUBER      : COLON      CRISTINA   FRANKLIN  
MIKE       : RAYMOND    NEWTON     VARGAS     HOGAN     
RONALD     : BERT       JARROD     AUTUMN     SIMPSON    MONROE     BRYAN     
MCCALL     : BOBBIE     ABEL       AYERS      WILKERSON  BRIDGET   
ALFREDA    : ROMERO     STEVEN     DAMIAN     MADDEN    
KARYN      : LORENZO    CARLO      HAROLD     JIM       
THOMPSON   : VONDA     
HURLEY     : HIRAM      VICKI      BOBBI      NOEL       CONSUELO  
HULL       : CAROLYN    CATHERINE  CURRY     
MARCI      : ROBINSON   HOMER      MCMAHON    RAUL      
TAMMI      : WEBSTER    BURGESS    VALENTINE  AVA       
ELISEO     : ALEXANDER  RICKY      LORENA     WASHINGTON
CAMACHO    : LANA       BAKER      DYER       PARRISH    KRISTEN    DON       
LENORE     : BURKS     
BOYD       : PAT        HODGE     
HEIDI      : HART       DECKER     RONNY     
CARISSA    : KNOX       MARGARITA  ISABELLA   EARNEST   
MALDONADO  : GALLAGHER  BARNETT   
CARMINE    : SOSA       ADDIE     
PAULETTE   : MAVIS      BALDWIN    MARY       BOYER      JESSIE     ADKINS     BRAY       PARSONS   
HOPKINS    : JUSTINE    DUKE      
MARYELLEN  : DEANA      CHAVEZ    
MOSS       : REESE      EARL       LEONARD   
CHANDLER   : MOLLIE     LEBLANC    GARZA      COMPTON    ISABELLA  
GRETA      : IVANA      WHITFIELD  JOSE       MARSH      WATTS      WALLER    
LORRAINE   : MONTY      WALDO      ABRAHAM    RAYMOND    MILLS      CHRISTIAN 
RASMUSSEN  : NICHOLS    KENNEDY    KURT       MOHAMED    JOAN       GALLAGHER 
CROSS      : STEPHENS   PATEL      MARTHA     LINDSAY    HAZEL     
AYERS      : MCCALL     LENORA     ROBERT    
BEACH      : MILLICENT  ELIZA      LAUREL     BRADFORD  
ODOM       : FRANKIE    ROWE       HUBBARD    GIBBS     
KENDALL    : KELLEY     CASEY     
PAM        : SELENA     HILARIO    EDGARDO    CROSBY    
VICTORIA   : MCKAY      FRY        SALINAS    ELBERT     MANNING    TYLER     
DENA       : MCFADDEN   BOBBIE     CAIN       FINLEY    
LANE       : DIONNE     HERMINIA  
SUAREZ     : LITTLE     EMILE      SHEPARD    HALL       ALBERT    
MARA       : WALTON     WEBSTER    MARGUERITE HENRIETTA  ANTHONY    LESSIE    
CLAY       : EVANGELINE STANLEY   
HOLLIE     : CATHRYN   
CHAVEZ     : MARYELLEN  MASSEY    
LES        : MAXWELL    ROY        MONTOYA    ISIAH      RAYMOND    BRAY      
THURMAN    : MERCADO    GREGORY    GLASS      SHARRON    CASSIE    
HUGH       : KATY       NETTIE     NANETTE    CINDY      ELBERT    
SCHULTZ    : TERRI     
SAMUEL     : MARISOL    COOLEY     DALE       STANLEY   
FRANCESCA  : CLAYTON    HOOD       MACIAS    
HOLCOMB    : GILES      KELLER     STRONG    
SHANA      : ALBA       KYLE      
BUDDY      : BRENDAN    FREDERIC   PATRICK    KELLER     FUENTES   
NIGEL      : INGRID     SIMPSON   
MILLIE     : PERCY      JOY        SIMS       ISIAH      ENGLISH   
RICHARDS   : BARNES     FLOYD      FRANCIS   
BERGER     : XAVIER     GRAY       ARTHUR    
BURCH      : LEANN      ADKINS     GENARO     HUMBERTO   BRYAN     
SOLIS      : ALBA       ESTEBAN    BRANDI     LEON       LORNA      WINFRED   
FARLEY     : HENDRIX    FREDERICK  JACKSON   
DOMINGO    : JENNINGS   BARKER     JULIET     ROD       
DOROTHEA   : HANNAH     ASHLEE     JESSICA    ROJAS      HAWKINS   
ELIZA      : BEACH      ADELINE    STACI      JOSUE      LEONARD    GUZMAN     ROBERTSON 
RODRIGUEZ  : VICKI      HOGAN     
JOSEPH     : MCLAUGHLIN SHEPHERD  
GALEN      : FLORINE    GARZA      BRANDI     HOOD      
MOLINA     : LUCIEN     DELMAR     CONSTANCE 
RICARDO    : ROBERTA    REYES      HENDRIX    BRIGITTE   CLEVELAND  CHARLES   
CARMELO    : HEATH      PACHECO    IRVIN      MARVIN    
RODGERS    : PERRY      DEJESUS    LORENZO    TONI      
ORR        : FREDERIC   KELLER     HOGAN     
DAWN       : KNOX       ALBA       DENIS      GERARDO    DARRYL    
PETER      : BRADLEY    BRADSHAW   SAUNDERS   MERCER    
LULU       : SCOTT      DEAN      
TREY       : HARVEY     HERIBERTO  NIELSEN    RODERICK  
HENDRIX    : WOLF       FARLEY     RICARDO    KEVEN      ROCKY      ALICIA    
SUSAN      : RAMIRO     TRICIA     DEJESUS    DANIELLE   MATTHEWS   MCLEAN    
LUPE       : ROY        WINFRED   
JONI       : STACIE     ROOSEVELT  POOLE     
HERMINIA   : MCCULLOUGH LANE       KOCH      
EVERETT    : JOHANNA    SLOAN      MORENO     NATASHA   
WEAVER     : MONTGOMERY XAVIER     JORDAN     CHERI     
NETTIE     : HARVEY     HUGH       MCCARTY    ERNA      
WILLIS     : GILMORE   
VERN       : COMBS      WINFRED    PARSONS    BRYAN     
RITA       : JACLYN     DEWAYNE    WALTER     MASSEY     HENRY      TABITHA    TRACY     
EMILE      : SUAREZ     AIDA      
FERNANDEZ  : INES       LAMBERT    BRIGITTE   ROSA       JARROD    
ALVAREZ    : HANSON     KATHARINE  GIBSON     BRAY       EVE       
ED         : CHARITY    JARED      ROBERT    
BOYER      : VILMA      PAULETTE   TAMMY      RAY        KENTON     CHANCE    
FLORINE    : WILCOX     GALEN      HOLDER     DUKE       BILLIE    
FOWLER     : FLETCHER   ROBT       OLSEN      DANIEL    
LATISHA    : DIXIE      VARGAS     REINALDO  
LETICIA    : BUCK       MERCER    
CARLO      : KARYN      MAE        JESSE      JOAN      
CONRAD     : DIAZ       REUBEN     DARRYL    
ELVIRA     : GILL       FULTON     ADELINE    JANETTE    GONZALES   FERRELL   
MERLIN     : COLLIER    MYRA       ISIAH      LEONARD   
KOCH       : GRIMES     LORENZO    ART        HERMINIA   HARRISON   TANYA     
PARK       : LANGLEY    JACKSON    MACIAS    
KEVEN      : KATY       HENDRIX    DENNIS     BIRD      
ARMSTRONG  : REEVES     JACOBS    
KURT       : ANNA       KNOWLES    SPENCE     RASMUSSEN  WATERS     LINDSEY   
ZAMORA     : MERCADO    FRANCES    NIKKI      KIDD       TY        
SEBASTIAN  : FRY        DIXON      TERRENCE   WENDI     
AL         : ANTONE     RAMOS      RICHARDSON
MARCUS     : WILLARD    WYATT      FANNIE     FRY        PIERCE     REYNA      ROTH      
MICHEAL    : ROSETTA    ARRON      KRISTOPHER CONTRERAS  ELIJAH     WHITNEY    POLLARD   
BLANCHARD  : GILL       JORDAN     HANEY      FOSTER     CHRISTINE 
TREVINO    : FLOYD      RIVERA     FOREMAN    MUELLER   
DUSTY      : PRINCE     CONNIE     JILL       ROMERO     HEAD       PETERSEN  
BRIGITTE   : CAITLIN    ETTA       RICARDO    FERNANDEZ  ADKINS     DAREN     
ROSS       : GRACE      ENGLISH    PATRICK    COLEMAN    HARRISON  
SONYA      : PRINCE     POTTS      HOMER      PATSY     
LELIA      : MARY       BRADSHAW   MCGOWAN   
ROSEANN    : CLARA      ROBT       ADKINS     CORRINE   
OTIS       : SIMON      CHUCK      MACK       MAYNARD   
NORRIS     : HEBERT     DEANDRE    ALTA       MILLICENT  BARKER     GOODMAN    VICKI     
SALAZAR    : CONLEY     DALE       ANDREWS    QUINN      MACK      
MAE        : ETTA       WILL       CARLO      CANTU      HILL      
WILEY      : DANIELS    MARGERY    LUCY      
LEVINE     : INES       ROMERO     GOODWIN    OTTO       FUENTES   
NITA       : CLYDE      RORY       ALISSA     TRAVIS    
CATHERINE  : HULL       MYERS     
BARKER     : HANNAH     CHELSEA    DOMINGO    NORRIS    
JESSIE     : TRENTON    WARD       PAULETTE   FAITH      DUNLAP    
PATEL      : CROSS      DELACRUZ   BERNADETTE FRANCISCO 
LORI       : GARRY      LARSON     TERRENCE   AISHA     
TERRI      : DARNELL    SCHULTZ    WILFORD    KELLER    
MAYS       : NEWMAN     NORMA     
FOREMAN    : TREVINO    POLLARD    CASSIE    
ROCKY      : FISCHER    HENDRIX    FLEMING    ROSALES   
GERARDO    : ERICK      DAWN       MARIANO    BARNETT    RACHAEL   
FRANCES    : ROSETTA    VONDA      CLAUDETTE  CECIL      ZAMORA     ALEXANDRA 
EDGARDO    : PAM        SALINAS    DORA       ANASTASIA  JULIAN    
PORTER     : AUTUMN     OTTO       JOHNSTON  
NANETTE    : RIOS       HUGH       JANINE     MURIEL     COMPTON    SHANNON    HARRIS    
PACHECO    : ISSAC      CARMELO    TATE      
KATHLEEN   : HIGGINS    BRUCE      CARDENAS   HARRIET    ENID       ODONNELL   MERRILL   
SHIRLEY    : GARRY     
AURELIA    : CLEMENTS   ROJAS      WHITNEY    MAYNARD   
POPE       : MAVIS      AVA        BRADLEY    FORREST   
VICTOR     : VALERIE    MOSES      STARK      HUBBARD    RENA       KEVIN     
DANIELS    : WILEY     
MARTHA     : JOANNA     CROSS      PRUITT     JEREMY     DYLAN      HOWARD    
BRIANA     : BRIDGETTE  MORRIS     VEGA       ADKINS     NORMA     
REYNA      : HOUSTON    DAVIS      MARCUS     MCINTYRE  
QUINCY     : RICO       DEANA      MARSH     
HOLDER     : COOK       MILES      FLORINE    BRADSHAW   SANFORD    CANDY     
NAPOLEON   : MYRA       FRANCIS   
GABRIELA   : RAMOS      SAVAGE    
BETHANY    : REESE      DENNIS     PARKS     
SHEPARD    : HIGGINS    SUAREZ     CASEY     
LAUREL     : MARIA      DEANDRE    BEACH      VANCE     
FLORENCE   : MEADOWS    SWANSON   
ROSA       : FERNANDEZ  WILFORD    GEORGE     ANTHONY    TURNER    
HAROLD     : KARYN      LANCASTER  RAYMOND   
SANDOVAL   : MENDOZA    SOLOMON   
HENRIETTA  : CHARLOTTE  FRYE       MARA       DONALD     HUFFMAN    ROBERT     MOSLEY    
WHITFIELD  : FROST      FEDERICO   GRETA      WHITE      LORNA      EVANGELINE
CLARA      : REEVES     HENSLEY    ROSEANN   
FULTON     : LESLIE     MARION     AMANDA     ELVIRA     WILBUR     ISABELLA   HODGE      SHARRON   
FULTON     : INA        MARTIN    
ROBIN      : MYRA       ESMERALDA  TOMMY      SALVATORE 
WALTER     : RITA       DELORIS   
JANINE     : MCCULLOUGH LUCIANO    NANETTE    JARRED     ADKINS     SANTANA   
BENTLEY    : WOLF       CAROLINE  
JASPER     : YANG       NOELLE     BONNER     BOYLE      SALVATORE 
ERNESTINE  : LEVI       NOLAN     
GARZA      : MCCARTHY   OSCAR      MARTINEZ   CHANDLER   GALEN     
EVANGELINA : XAVIER     WOODWARD   SUZETTE    LACY       TANYA      DEVON     
SHAWN      : DEWAYNE    JEWELL     SONNY      ANNABELLE 
INGRID     : WIGGINS    NIGEL      SUZETTE    LACY      
LINDA      : MCFADDEN   DELACRUZ   STEVEN     TANIA     
SIMS       : BAIRD      KATHARINE  MILLIE     YVETTE    
MURIEL     : HIRAM      CONNIE     BUCKNER    NANETTE    ADAMS     
ANNETTE    : ELLIS      LUCIANO    HENSLEY    RUSSELL   
LORIE      : FANNIE     FEDERICO   GARRY      DEMETRIUS  CURTIS    
MYRA       : MERLIN     NAPOLEON   ROBIN      FRANCIS   
GLASS      : FRIEDA     THURMAN    JARRED     TY        
LINDSAY    : FOX        CROSS      GIBSON     IRVIN     
ROBT       : ALVIN      ELOISE     PETTY      FOWLER     ROSEANN    RICK       LACEY     
PRUITT     : HOUSTON    ROBBY      MARTHA     BUCKLEY    CARROLL   
FOSTER     : ROBBY      BEST       BLANCHARD  SELLERS   
VINCENT    : TRAVIS    
NOELLE     : JILL       CHAN       ADAM       JASPER     LORNA     
GOODMAN    : JAMAAL     NORRIS     LEMUEL     SHERMAN    DEWITT    
RYAN       : JILL       TRICIA     GLORIA    
RICHMOND   : BUTLER     GIBBS     
LUCAS      : AVIS       ALTON      NANNIE     DIXIE     
DYER       : CAMACHO   
RUSSELL    : KIM        AMELIA     ANNETTE    ANA        JARRED    
BOB        : BARNES     NEAL       TIMMY      TINA       ALFONSO   
MARIANA    : GUY        MAYER      RUSSO      VAUGHN    
CRANE      : LAUREN     GONZALEZ   STEELE    
ADELINE    : THELMA     HOUSTON    ELIZA      ELVIRA     MCCRAY     HUFFMAN   
GINGER     : TRENTON    TILLMAN    DEWAYNE    VICKY     
NANNIE     : YANG       LUCAS      MENDOZA    FLYNN      PHELPS    
MALLORY    : NICOLE     MCMILLAN   FISCHER    LORENZO   
REESE      : KATHY      MOSS       BETHANY    MAYER     
WILBUR     : MCCONNELL  VERA       PENNINGTON MARTINEZ   FULTON    
CLEVELAND  : DEENA      RICARDO    SERRANO    CINDY      PARSONS   
HOLT       : TODD       HUNTER     MARIE      ERICKA     HECTOR     CHANCE     POOLE      MAURICE   
LEONEL     : OLA        DUNCAN     HOLLOWAY  
BOOTH      : WATERS     JEWELL     RAPHAEL   
FERN       : CHARLOTTE  BURTON     ENRIQUE    RACHAEL   
CALDWELL   : WOODARD   
WILFORD    : ALEXANDER  TERRI      ROSA       CONNER     MARSHALL  
HENDERSON  : CASE       TAMERA     HENRY     
LANCASTER  : OCTAVIO    BETTE      HAROLD     JUAREZ     CARDENAS   KRISTINE  
MARGARITO  : ANTONE     CONLEY     HECTOR     WENDY     
BOLTON     : INES       IVANA      MOHAMED    MACDONALD  MATTHEWS  
BRUCE      : CHRISTI    MICAH      VICKY      KATHLEEN  
DENNIS     : ERIKA      KEVEN      BETHANY    REFUGIO   
HAYS       : LOURDES    CONTRERAS  ALFONSO    PALMER    
SUZETTE    : TRACEY     DAVIS      EVANGELINA INGRID     EARLENE   
BROWN      : SOTO       MARIBEL    LEMUEL     CORNELIUS 
KELLEY     : BORIS      SCOTT      KENDALL   
RODRIQUEZ  : MCDONALD   COLLIER    HICKS      HERMAN     JACKSON    WEBB      
JERALD     : JOHNATHAN  BARTLETT   ENRIQUE    NICHOLSON  ROBERTSON 
DELACRUZ   : PEARSON    SIMON      PATEL      LINDA     
FREDRIC    : CANDICE    MCKEE      BULLOCK   
ANA        : RUSSELL    CHUCK     
JIMMIE     : MARGARITA  BRADLY    
MYERS      : CATHERINE  DANIEL    
EARL       : LOTTIE     MOSS       DANIAL    
VIRGIE     : TORRES     DUNCAN    
STEVEN     : SAM        MOSES      ALFREDA    LINDA      EFREN      HUNT      
ANTONIA    : LACY       MAXINE     HOOD       SELLERS   
LIZZIE     : SHARON     BRENTON    MARKS     
CATHRYN    : MCLEOD     ANNIE      HOLLIE     SUSANNA    PALMER     WONG      
MARGERY    : MAVIS      PICKETT    MARYANNE   WILEY      MELBA      MCINTYRE  
SNOW       : MONTY      BLEVINS    WILKINSON  JILLIAN    AYALA      TURNER    
WISE       : CANDICE    DALE      
AUGUSTINE  : PRISCILLA  SALINAS    COLLINS   
GLORIA     : FOX        MERCADO    ALBA       FREDDIE    RYAN      
CONTRERAS  : STOUT      MICHEAL    HAYS       KYLE      
FLEMING    : ROCKY      ELDON      LOGAN     
CAMERON    : DERICK     ERIN       LAUREN    
ESMERALDA  : CAITLIN    ROBIN      PUGH      
HICKS      : RAMSEY     BLACKWELL  ELOISE     BERTIE     RODRIQUEZ  RANDALL   
OMAR       : HOUSE      EARNEST    ISIDRO     TRAVIS    
GEORGE     : LETITIA    HARRINGTON ROSA       VALENZUELA ESTRADA   
AURORA     : ELMA       MCMILLAN   DAPHNE    
PRISCILLA  : MCLAUGHLIN DONNA      AUGUSTINE  JEWELL     ELBERT    
CALLAHAN   : WALTON     AMIE       CHAN       GENEVA     ALBERTO   
ROSEMARY   : SWANSON    TOWNSEND   CONSTANCE  BEASLEY   
FRANCIS    : RICHARDS   NAPOLEON   MYRA       AUTUMN     PATSY     
TAMMY      : STACIE     LEWIS      BOYER      JAMEL     
LEANN      : BURCH      HALL      
ERICKA     : HOLT       BRIGGS     LESSIE     PETERSEN  
JANETTE    : ELVIRA     KELLER     HAYDEN    
EARLENE    : SUZETTE    SHEPHERD   BULLOCK   
JACOB      : WILKERSON  ALYSON     TURNER     TRAVIS    
CONNER     : BRYON      WILFORD    NORA      
DELMAR     : MOLINA     AISHA     
TATE       : WALTERS    ALLISON    KERI       PACHECO    SCHROEDER  DALTON     MCMAHON   
KIP        : ADAM       MOISES     ERIK       COLLINS   
WALLS      : EMORY      MENDOZA   
NIKKI      : LETITIA    HOBBS      PITTMAN    ZAMORA     CLEMONS    MARCIA     BOWEN     
GUTHRIE    : DAREN      ODONNELL   DUFFY     
ASHLEE     : REEVES     DOROTHEA   JOSE      
MASSEY     : COMBS      STUART     CHAVEZ     RITA       LOTT       CHUCK      HOWELL    
TOMMY      : ROBIN      DUFFY     
STEVENS    : AMELIA     ROSE       LOWE      
COLLEEN    : ROB        SARA      
VEGA       : BRIANA     SAMPSON    LAURI      ALI       
TERRY      : BARLOW     CARROLL    MAXINE     CHUCK      HOLLOWAY  
NORA       : PHILIP     CONNER     FINLEY    
JESSE      : ANNMARIE   CARLO      ANTHONY    ROTH      
ASHLEY     : MEREDITH   FRANCISCO  DELBERT   
BERNADETTE : BARTLETT   PATEL      LAWANDA   
TIMMY      : REYES      GONZALO    BOB        GOLDIE     LEONARD   
JANICE     : LEVI       DEENA      ISRAEL     KRISTEN    FLYNN     
MONTOYA    : CANTRELL   LES        MOODY      JILLIAN   
EFREN      : BEAN       STEVEN     CARROLL    GIBSON    
HERIBERTO  : HOLDEN     DIONNE     LANGLEY    TREY      
SHARON     : LIZZIE     DEMETRIUS  ROMAN      LLOYD      HOLLAND    PETERSEN  
JUANITA    : BROCK      STOUT     
AHMED      : MOSES      HANEY      BUCKLEY    RAUL      
CARR       : ROCCO      BURKS     
JARROD     : COOLEY     RONALD     FERNANDEZ  LAURI      MACDONALD  EARNEST   
STEWART    : HOUSTON    WHITLEY   
RAY        : BOYER      OLSON      WENDI      HELGA     
TRAN       : ABE        ELOISE     JAMEL     
MCCORMICK  : TARA       LE         DUNLAP    
JUAREZ     : KATHERINE  ISSAC      LANCASTER  BRYANT     HOLLOWAY  
VALENTINE  : NOLAN      TAMMI      CAROLE    
SERRANO    : LUCILLE    CASANDRA   CAROLYN    CLEVELAND  RONNY     
DUKE       : STACIE     HOPKINS    FLORINE    HUBBARD    CROSBY    
HECTOR     : KIM        CAROLYN    HOLT       MARGARITO  CAIN      
LACY       : EVANGELINA INGRID     ANTONIA    AYALA      EVE       
AVERY      : MARION     DONA       ROSALES   
MELBA      : MARGERY    LIDIA      MCCLURE   
GOLDIE     : TIMMY      HODGE      PHELPS     ROBERTSON  TY        
ISIAH      : FREDERIC   ANDREA     LES        MILLIE     MERLIN     KRISTINE   CORNELIUS  ROSALES   
JEREMY     : HORTON     PIERCE     MARTHA     ERNA       ALI        SHELLEY   
BARBER     : LUNA       CHAN       ADAM       JARRED    
LOWE       : STEVENS    KAUFMAN    NIELSEN    CORINNE    ANNABELLE 
ALFONZO    : FIELDS     MILLER     MCCRAY     NIELSEN    DEWITT    
BUCKLEY    : LEVI       ROXANNE    PRUITT     AHMED      BURRIS     BARBRA     KELLY     
CRAIG      : STEPHENS   KATHY      WINFRED   
ROBBINS    : WIGGINS    CARROLL    WATERS     MARISSA   
MABEL      : CRAFT      SAUNDERS   MERRITT    KRISTINE  
RUSS       : JOHN       RIVERA     JULIAN     CASSIE    
KIDD       : BARNES     NICOLAS    ZAMORA    
FAULKNER   : CHANEY     ALBA       GUZMAN     PHELPS    
SAMPSON    : HOUSTON    HENSLEY    VEGA       HAWKINS    TANNER    
ANDREWS    : CRYSTAL    ODELL      SALAZAR    MINNIE    
SALINAS    : VICTORIA   EDGARDO    AUGUSTINE  WELLS      NIELSEN    RANDALL   
DELANEY    : CARLSON    GUY       
AVA        : TAMMI      POPE       AYALA      CASTRO     HAYDEN    
NEIL       : OCTAVIO    DANIELLE   CHRISTINE  CORTEZ    
RAYMOND    : MIKE       LORRAINE   LES        HAROLD     TOWNSEND   JARED      SANCHEZ   
BUCHANAN   : LEANNE     DEANA      LIDIA     
EMILY      : LUCIEN     JOHNSON   
CONCEPCION : BOYLE      BATTLE     GREENE    
KAUFMAN    : AMELIA     LOWE       LEONARD    THADDEUS   COFFEY    
BRADLEY    : ANNMARIE   PETER      POPE       HERSCHEL  
JAYNE      : FORBES     DONA       BASIL     
SIMONE     : TUCKER     SIDNEY     ENRIQUE    EARNEST    JAY       
SHEPHERD   : MCKAY      PRINCE     GRIFFIN    JOSEPH     EARLENE    FRANKIE    ROBERTSON 
WILLIAMS   : KATY       BRIDGETTE  DALE       CHERRY     MARISSA   
MCINTYRE   : MCNEIL     BETTE      JUSTINE    REYNA      MARGERY    MCCARTY    PATSY      KASEY     
WILKINSON  : ROBBIE     GIOVANNI   SNOW       ODONNELL  
CAROLINE   : LENARD     MCKENZIE   REYES      SILAS      BENTLEY   
HOMER      : MCNEIL     MARCI      SONYA      AMADO     
PARRISH    : GUY        CAMACHO    DIXIE     
COX        : EUGENIA    JACOBS     ALINE     
STACI      : BERT       ELIZA      POOLE     
JACOBS     : BLEVINS    JOHNS      LOTTIE     ARMSTRONG  COX       
ROSARIO    : OLGA       WEBER      YOUNG      DONNY     
MEADOWS    : GONZALO    HORN       FLORENCE   ANNABELLE 
BRADSHAW   : TAMERA     LOURDES    PETER      LELIA      HOLDER     ROTH       KERR      
MUELLER    : CRISTINA   TREVINO    NAVARRO   
HAZEL      : BRANDY     CROSS     
JARRED     : JANINE     GLASS      RUSSELL    BARBER     NADINE    
BRUNO      : MICAH      BATTLE     DALTON     TRAVIS    
SWANSON    : DUNN       FLORENCE   ROSEMARY   GILLESPIE 
CARROLL    : ESTES      ABEL       PRUITT     TERRY      EFREN      ROBBINS   
VALENCIA   : DELGADO    DIXIE      SAVANNAH  
PRESTON    : LANGLEY    GIOVANNI   EDWIN      CHARLES   
PEREZ      : MILDRED    HERRING    NICHOLSON 
MARCELO    : HERMAN     KNIGHT     HARRIS    
MILLS      : MCCONNELL  CHARLOTTE  LAMBERT    LORRAINE   KEITH      NIELSEN   
GENEVA     : CALLAHAN   GIBSON    
ERMA       : WARD       ABE        AUSTIN     TURNER    
TINA       : JANELLE    BOB        MOODY      ROSALINDA 
TOWNSEND   : DILLON     ROSEMARY   RAYMOND    GENARO     HUFFMAN    ANGIE     
BRENTON    : LIZZIE     IRA       
DELORIS    : PITTS      THOMAS     WALTER     GARNER    
CANTU      : NORTON     MAE        COLLIN     AUTUMN     JOYNER    
PAYNE      : HORN       FORREST    TONIA     
ANTHONY    : MARA       ROSA       JESSE      IRA       
DELGADO    : GLENN      HERBERT    LUNA       KNOWLES    VALENCIA   ENGLISH    ALI        CHARMAINE 
MCCRAY     : KATHERINE  ADELINE    ALFONZO   
FREEMAN    : RICE       CARLA     
ESTEBAN    : SOLIS      SOLOMON    BRIDGET   
GRACE      : PATE       ROSS      
ADAMS      : MURIEL     CARVER    
RICKY      : ELISEO    
LORENA     : ROSE       ELISEO     ELLIOTT    KNIGHT    
KARLA      : DAMIAN     FUENTES   
WOODARD    : CRYSTAL    HEBERT     CALDWELL   JOHNNIE    FRANKLIN  
JARED      : MAVIS      PITTMAN    TRACEY     ED         RAYMOND   
WELLS      : FLOSSIE    SALINAS    ROMAN      ONEIL     
NEWTON     : MICAH      STARK      MIKE       CARVER    
BURRIS     : MOSES      GILL       BUCKLEY    ROSALINDA 
MARCY      : BURTON     MERLE      BOWMAN     HELGA     
BENITO     : NICOLE     LUNA       LEROY     
LARSON     : FANNIE     LORI      
VICKI      : MAC        BRYON      HURLEY     RODRIGUEZ  NORRIS     ROOSEVELT  SELLERS   
DONALD     : DERICK     SOTO       HENRIETTA 
WENDY      : WALTON     MARGARITA  NICOLE     KRISTIE    JULIA      MARGARITO 
AUBREY     : BRYON      CAITLIN    BOBBIE     HENSLEY    MILDRED    ELLIOTT    OLSON     
DAVID      : ANDERSON   DEJESUS    JEAN       FREDERICK 
COMPTON    : ETTA       CHANDLER   NANETTE   
PUGH       : RAMOS      ESMERALDA  PARSONS   
MENDOZA    : MADELINE   BERTIE     JORDAN     SANDOVAL   NANNIE     WALLS     
KEITH      : RAMSEY     BARRERA    MILLS      IAN        SAVANNAH   TANNER    
MERLE      : ROB        JOHN       TODD       MARCY      CASEY     
BREWER     : HERSCHEL   STEPHENSON
VERNON     : EMORY      POTTS      JULIAN    
SCOTTIE    : KRISTOPHER NORMA      PHILLIP   
ALICIA     : ANDY       WARNER     HARRELL    MILES      HENDRIX    FAITH     
EARLE      : DILLON     WATTS      PASQUALE   GREENE    
IAN        : NUNEZ      ROY        KEITH     
JEAN       : ALVIN      DAVID      LLOYD     
SAUNDERS   : TOBY       JULIO      PETER      MABEL      PHELPS    
DECKER     : YANG       FLORES     HEIDI      PETERSON   CORNELIUS  RICHARDSON
JOSUE      : BARRY      KENNEDY    ELIZA      RICK       AMADO      BARBRA    
SYKES      : FIELDS     ISSAC      WILLIE    
MILDRED    : LATONYA    JODIE      LOURDES    PEREZ      AUBREY     DAREN     
SYBIL      : RICHARDSON
DEANNE     : CASE       ROMERO    
BONNER     : CASTILLO   JASPER     KENDRA    
NIELSEN    : TREY       LOWE       ALFONZO    SALINAS    MILLS     
ENGLISH    : ODELL      MILLIE     ROSS       DELGADO   
HOUSE      : HARRINGTON OMAR      
LEONARD    : NUNEZ      MOSS       ELIZA      MERLIN     TIMMY      KAUFMAN    STRONG     MILO      
WATERS     : HIGGINS    KURT       BOOTH      ROBBINS   
BENTON     : MARK       WARNER     ERICKSON   CLINT      ENID       MOSLEY    
HARMON     : ABRAHAM    ROY        SAVAGE     MAURICE   
DIXON      : LATONYA    WEEKS      SEBASTIAN  SETH       BERNARDO  
ISABELLA   : CARISSA    CHANDLER   FULTON    
GARNER     : JOHANNA    LYDIA      CHRISTA    DELORIS   
MOODY      : DEANA      MONTOYA    TINA       DAVENPORT 
LUISA      : PITTMAN    TOM        ERNIE      OWEN      
PUCKETT    : JOHNATHAN  HENDRICKS 
WALL       : DARNELL    JOHNSON   
DEMETRIUS  : GREGORY    LORIE      SHARON    
MOHAMED    : ROBERTA    RASMUSSEN  BOLTON     MANNING   
GIBSON     : GILMORE    ANIBAL     ALVAREZ    LINDSAY    EFREN      GENEVA    
SOLOMON    : BRIDGETTE  SANDOVAL   ESTEBAN   
GOOD       : DEENA      DARRELL    ELDON      BETH      
ELVA       : ROXANNE    LOTT       ROSALES    FRANCISCO 
NIEVES     : BRIDGETTE  ART       
JEWELL     : EMORY      ANITA      SHAWN      BOOTH      PRISCILLA  WENDI     
JOSE       : NICOLE     FLETCHER   BURTON     GRETA      ASHLEE    
DIXIE      : NUNEZ      HUNTER     LATISHA    LUCAS      PARRISH    VALENCIA  
GRAY       : KATHERINE  BERGER     TEDDY     
FULLER     : GILBERTO  
ELDON      : WELCH      FLEMING    GOOD       GILES      FAITH      TERENCE    LE         DEAN      
JESSICA    : VILMA      LITTLE     DOROTHEA   BURKS     
GILLESPIE  : COLON      CASE       LARSEN     SWANSON   
ALEXANDRA  : VALERIE    WILL       FRANCES    CASTRO    
IRA        : FANNIE     BRENTON    ANTHONY   
BIRD       : KEVEN     
TAMMIE     : THELMA     TRACEY     KYLE       LIDIA     
RORY       : NITA       PARSONS   
MERCER     : LUNA       PETER      LETICIA    REGGIE    
STANTON    : LUCIEN     SCOTT      WASHINGTON RAUL      
GRACIELA   : CAROL     
COLLIN     : REYES      CANTU     
BOBBI      : ANDERSON   KERRY      HURLEY     CLEMONS    STANLEY   
MARKS      : POTTS      LIZZIE    
ADKINS     : PAULETTE   BURCH      BRIGITTE   ROSEANN    BRIANA     JANINE    
HERMAN     : BROCK      RODRIQUEZ  MARCELO    CHANCE    
IRVIN      : CARMELO    LINDSAY   
PATRICK    : BUDDY      ROSS       AIDA      
VALENZUELA : AMIE       ROY        PHILIP     GEORGE    
WILKERSON  : LOIS       ANNIE      MCCALL     JACOB      TONIA     
ANTONIO    : PITTS      JARVIS     BONITA     CLYDE      STRONG    
HERSCHEL   : HERRERA    STEFANIE   BRADLEY    BREWER    
DWIGHT     : ISABELLE   HENSLEY    AIDA      
HURST      : JOHNATHAN  TARA       SAVANNAH   FERRELL   
PAT        : CLAYTON    MARGUERITE MOLLIE     BOYD       DURAN      LORNA      MAYNARD   
LAURI      : MCLEOD     VEGA       JARROD    
HENRY      : MARISOL    RITA       HENDERSON  MATHIS    
MARSH      : BOWERS     GRETA      QUINCY     NGUYEN    
NOEMI      : MILLER     HUMBERTO   OLSON      HUDSON    
CHRISTIAN  : ANITA      FEDERICO   LORRAINE   STANLEY   
SHANNON    : ALVIN      NANETTE   
ARNULFO    : IRIS       PAMELA     CAROLYN    HOGAN      RUSSO     
SETH       : HARVEY     DIXON     
INGRAM     : PERRY      MILAGROS   CAROL     
ALFRED     : LEVI       STEELE     NICOLAS    WIGGINS    ALISSA    
CHRISTINE  : BLANCHARD  NEIL       CHERRY     NADINE    
CINDY      : LEACH      TYREE      HUGH       CLEVELAND 
DAVENPORT  : PHILLIPS   MANUEL     MOODY      VANCE      CASTRO    
SANFORD    : MCNEIL     HOLDER     CUMMINGS   PHELPS    
COLEMAN    : LEANNE     DIANE      ROSS       MINNIE    
JIM        : HERBERT    ABRAHAM    JOANNA     KARYN      DAMON     
GENARO     : WEBSTER    BERT       BURCH      TOWNSEND   TABITHA    MCGOWAN   
CORINNE    : WALTON     GARTH      LOWE       HOLLOWAY  
ELBERT     : RICE       VICTORIA   HUGH       PRISCILLA  FUENTES   
DAREN      : VELMA      BRIGITTE   GUTHRIE    MILDRED    SOSA       JOHNSTON  
YVETTE     : CHARLOTTE  SIMS      
MORROW     : TODD       NUNEZ      IRWIN      RANDOLPH  
GUZMAN     : MERCADO    STRICKLAND ELIZA      FAULKNER  
NORMA      : DORIS      TASHA      MAYS       BRIANA     SCOTTIE   
DAMIAN     : ALFREDA    KARLA     
HUMBERTO   : FIELDS     CHAN       BURCH      NOEMI      SUSANNA    KRISTINE  
DICK       : LEE        BRANDI     CLINT     
SONNY      : HOBBS      CAROLYN    SHAWN      DUNCAN    
MATHIS     : BENJAMIN   SHERYL     HENRY     
JULIET     : PERRY      DOMINGO    ENID       ROSALES   
KRISTEN    : HINTON     CAMACHO    JANICE     KERRI      BAUER     
SARGENT    : PAMELA     KATHARINE  HERRING   
MCCARTY    : ROSETTA    BYRD       JUSTINE    EDMUND     NETTIE     MCINTYRE  
TANIA      : WINTERS    LINDA      RANDALL   
JULIE      : YANG      
RONNY      : COPELAND   CASE       LEBLANC    HEIDI      SERRANO    ROBERT    
HENDRICKS  : CLYDE      ART        PUCKETT   
BOWMAN     : NEWMAN     MARCY      RICK       ROTH      
HARRISON   : PAMELA     GILBERT    WILL       KOCH       ROSS       LEMUEL    
DORA       : EDGARDO   
ELIJAH     : LUCILLE    NEAL       SERGIO     MICHEAL    NAVARRO    OLSEN     
ERICKSON   : FLORES     BENTON     BASIL      HAYDEN    
TEDDY      : GRAY       AISHA     
REFUGIO    : BONITA     DENNIS     STACY     
LOTT       : MASSEY     ELVA       HOGAN     
WATTS      : AGNES      GRETA      EARLE      TERRENCE  
GILES      : TABATHA    MCKENZIE   HOLCOMB    ELDON      CUMMINGS  
VAN        : SOTO       FORBES    
BULLOCK    : CHAN       FREDRIC    EARLENE   
GOODWIN    : MAC        LEVINE     MITCHELL  
TORRES     : HOLDEN     ESTES      WALSH      VIRGIE     MAXINE     DON        REILLY    
WALLER     : CLEMENTS   GRETA      ROD        KRISTINE   CHARLENE   DUFFY     
RAPHAEL    : BOOTH      PARSONS    RUSSEL    
ELLIOTT    : LORENA     AUBREY     JOSEPHINE  DEAN      
MACDONALD  : ROSETTA    BOLTON     JARROD     QUINN      PETERSON   HOOD      
JAMAR      : CAROLYN    DARCY      DONNA      ART       
LEMUEL     : LEE        MERCADO    DAVIS      GOODMAN    BROWN      HARRISON   BRYANT    
DARIN      : LEONOR     ANDERSON   NUNEZ      HALL       ROSALES   
ROJAS      : DOYLE      DOROTHEA   AURELIA    BARBRA    
BOYLE      : JASPER     CONCEPCION CASTRO     KRAMER    
KENTON     : TRACEY     CRAFT      BOYER      GATES     
MOISES     : KIP        CHUCK     
AUTUMN     : RONALD     PORTER     FRANCIS    CANTU      OTTO       ESTELLA   
ROOSEVELT  : SPENCE     JONI       VICKI      ISIDRO    
QUINN      : SALAZAR    MACDONALD  CURTIS    
NAVARRO    : PAMELA     MUELLER    ELIJAH     LYNN      
FAITH      : HUGHES     ALTON      JESSIE     ALICIA     ELDON     
CAIN       : BENJAMIN   DIANE      DENA       HECTOR     FERRELL    SHELLEY    CROSBY     ROTH      
CHANCE     : BOYER      HOLT       HERMAN    
BRANDI     : SOLIS      GALEN      DICK       DON        THADDEUS  
ROSALINDA  : PHOEBE     WITT       TINA       BURRIS     STACY      MAURICE   
PATSY      : CECELIA    SONYA      FRANCIS    MCINTYRE  
SOSA       : SILAS      CARMINE    DAREN      KEVIN     
HODGE      : FEDERICO   BOYD       FULTON     GOLDIE     CONSUELO  
NANCY      : OLGA       NICHOLS    ORTIZ      MCMAHON   
LON        : ARTHUR    
TERRELL    : REEVES     EARNEST    KERRI     
MERRITT    : PAGE       JACKIE     MABEL      BERNADINE 
MATTHEWS   : SUSAN      BOLTON     SHERMAN   
CEDRIC     : LESTER     HERRERA   
MAXINE     : ANTONIA    TERRY      TORRES     TANNER    
SUSIE      : ENGLAND    STEFANIE   BROCK     
HALL       : SUAREZ     LEANN      DARIN     
ALYSON     : LENARD     SIDNEY     ROBLES     JACOB      MCMAHON   
CHERRY     : SILVA      HEATH      ENRIQUE    WILLIAMS   CHRISTINE 
CORTEZ     : NEIL       HELGA      MONA      
EVAN       : TABITHA    HOLLOWAY  
PHILLIP    : CRYSTAL    FRANKS     DARRELL    BONITA     SCOTTIE    ANASTASIA 
SUSANNA    : CATHRYN    HUMBERTO   FERDINAND 
MANNING    : ODESSA     VICTORIA   MOHAMED    ADDIE      BRYANT    
CARDENAS   : SILAS      KATHLEEN   LANCASTER 
OTTO       : TRENTON    LEVINE     PORTER     AUTUMN    
KYLE       : HARVEY     MARTINEZ   SHANA      CONTRERAS  TAMMIE     WELDON    
EARNEST    : CARISSA    OMAR       JARROD     SIMONE     TERRELL    CARVER     ANGELITA   ELINOR    
OLSEN      : WALDO      FOWLER     ELIJAH    
WILLIE     : BLEVINS    WOLF       ABEL       SYKES      HOOD      
SCHROEDER  : TATE       SIMPSON   
TONI       : LANDON     SWEET      WHITAKER   LUCIANO    CANTRELL   RODGERS    DON       
BILLIE     : ARIEL      CONLEY     ROSE       FLORINE   
OLSON      : BALLARD    RICO       NICHOLS    RAY        AUBREY     NOEMI     
ESTELLA    : SWEET      NEAL       AUTUMN    
ALBERTO    : LAUREN     CLAUDETTE  GLADYS     CALLAHAN  
SHARRON    : HILARIO    THURMAN    FULTON    
EDWIN      : NORTON     PRESTON   
WHITNEY    : MICHEAL    AURELIA   
CURRY      : HOLDEN     HARDY      KENT       XAVIER     NOE        HULL       TRENT     
HUFFMAN    : POTTS      HINTON     HENRIETTA  ADELINE    TOWNSEND  
TERENCE    : ELDON      RACHAEL   
SANTANA    : ERIN       MILLICENT  JANINE     STRONG    
ROMAN      : ANNA       FIGUEROA   SHARON     WELLS      MILO      
KENDRA     : ADAM       BONNER    
PETERSON   : LEVI       DECKER     MACDONALD  ALI       
ROD        : MONTGOMERY BRADLY     DOMINGO    WALLER    
BASIL      : GILBERT    CECELIA    ROSE       JAYNE      ERICKSON   BARTON    
RICK       : CHANEY     MARION     MILLICENT  ERIKA      ROBT       JOSUE      BOWMAN    
MICHAEL    : REUBEN     HOWARD    
BATTLE     : DEANDRE    CONCEPCION BRUNO     
COTTON     : GRIMES     LYDIA      OBRIEN    
BERNARDO   : AMELIA     DIXON      OBRIEN     CLAUDIA   
WASHINGTON : PAGE       HAMILTON   ANITA      ELISEO     STANTON   
JILLIAN    : SNOW       MONTOYA    GATES      MITCHELL  
TERRENCE   : ROBBY      BOWERS     SEBASTIAN  LORI       WATTS     
HERRING    : MONICA     PEREZ      SARGENT   
FREDERICK  : HOOPER     ANNA       FARLEY     DAVID     
DYLAN      : ANITA      VELMA      ROCCO      MARTHA     MARISSA   
SIMPSON    : MARGARITA  CLAYTON    RONALD     NIGEL      SCHROEDER  DUFFY     
BRADFORD   : BEACH      HAYDEN     SHERRI    
ERIK       : KIP        SHERMAN   
CALVIN     : ANDREA     BRADLY     MORRIS     GATES     
MARIANO    : CHARLIE    GERARDO    CARVER    
BARR       : TODD       BEAN      
ORTIZ      : COOK       NANCY     
DON        : JEFFERSON  CAMACHO    TORRES     BRANDI     TONI       FUENTES   
THADDEUS   : KRISTIE    SILAS      KAUFMAN    BRANDI     JOAN      
SCHWARTZ   : GILBERT    ENGLAND   
AYALA      : FRY        CLARK      MEDINA     SNOW       LACY       AVA       
HUDSON     : WALTON     JENNINGS   NOEMI      HUBBARD   
TRUDY      : FOX        MADELINE   VERA       ROWE      
ARTHUR     : BAKER      BERGER     LON       
COFFEY     : GLENN      KAUFMAN    MACIAS    
MAYER      : JODIE      MARIANA    REESE      DEAN      
NADINE     : JAIME      JARRED     CHRISTINE 
DUNCAN     : LESTER     LEONEL     VIRGIE     SONNY      ROYCE     
REGGIE     : MAVIS      BUCKNER    MERCER    
BLAIR      : HIGGINS    LE         COTE       ANGIE     
SHERMAN    : STOUT      GOODMAN    MATTHEWS   ERIK       FERDINAND  TABITHA   
LENORA     : CHRISTI    BLEVINS    SHERYL     AYERS      REYNOLDS   ANGIE      LORAINE   
CHUCK      : OTIS       ANA        MASSEY     TERRY      MOISES    
GATES      : GARTH      KENTON     JILLIAN    CALVIN     OWEN      
SOFIA      : MERCEDES   HART       MILES     
FERDINAND  : MARCELINO  MICAH      TYREE      ETTA       SUSANNA    SHERMAN   
ISIDRO     : LESLIE     OMAR       ROOSEVELT  RANDOLPH  
KELLER     : HOLCOMB    BUDDY      ORR        TERRI      JANETTE    JOSEPHINE 
CANDY      : ALLISON    CLAUDETTE  HOLDER    
JAY        : CLAYTON    MOLLIE     SIMONE     DURAN      REINALDO  
TURNER     : ROY        ROSA       SNOW       JACOB      ERMA      
MUNOZ      : MADELINE   GIBBS      LOGAN     
VARGAS     : PHILLIPS   MIKE       LATISHA   
WENDI      : TRACEY     BONITA     SEBASTIAN  RAY        JEWELL     TANNER    
RANDALL    : VASQUEZ    HICKS      SALINAS    TANIA      VAUGHN    
JOAN       : RASMUSSEN  CARLO      THADDEUS  
ERNA       : HENSON     NETTIE     JEREMY     LACEY      FRANKLIN  
VANCE      : LAUREL     DAVENPORT  LIDIA      GIBBS     
AMADO      : HOMER      JOSUE      COLLINS    EVE       
CARVER     : IRIS       ADAMS      NEWTON     EARNEST    MARIANO   
LACEY      : HOLDEN     PENNINGTON ROBT       ERNA      
INA        : PEARSON    HOLDEN     FLORES     FULTON    
HARRIET    : MONICA     KATHLEEN   BURKS     
AISHA      : IVANA      LORI       DELMAR     TEDDY     
ALI        : SCOTT      VEGA       JEREMY     DELGADO    PETERSON  
FORREST    : POPE       PAYNE     
ADDIE      : OLA        ELOISE     CARMINE    MANNING    LAWSON    
GALLAGHER  : LENARD     BROCK      MALDONADO  RASMUSSEN 
KNIGHT     : STEPHENS   MARCELO    LORENA    
KRISTINE   : ROB        GOMEZ      LANCASTER  ISIAH      MABEL      HUMBERTO   WALLER    
ROBERT     : STOUT      AYERS      ED         HENRIETTA  RONNY     
CLARENCE   : MANN       JARVIS    
WHITE      : KNOWLES    LEBLANC    WHITFIELD 
KERRI      : KRISTEN    TERRELL    MCLEAN     LYNN      
HOFFMAN    : HOGAN     
TABITHA    : SILAS      RITA       GENARO     EVAN       SHERMAN   
DURAN      : RAMIRO     MCLAUGHLIN PAT        JAY       
CORNELIUS  : BROWN      ISIAH      DECKER     LUCY      
HOWELL     : MASSEY    
CHARMAINE  : WALDO      KRISTOPHER DELGADO    SAVAGE    
ERNIE      : JOHNATHAN  DONA       LUISA      WONG      
MARSHALL   : WILFORD   
HOOD       : KERRY      FRANCESCA  GALEN      ANTONIA    MACDONALD  WILLIE    
HARRIS     : PATE       NANETTE    MARCELO   
FRANKIE    : ADAM       ODOM       SHEPHERD   STRONG     BRYAN     
LAWSON     : ADDIE     
DEWITT     : FOREST     SPENCE     GOODMAN    ALFONZO    DELBERT    CROSBY    
LEON       : HOBBS      BRIDGETTE  MARGUERITE BONITA     SOLIS     
SANCHEZ    : HIRAM      RAYMOND    MADDEN    
GONZALES   : ELVIRA     BEASLEY   
JEANNE     : LIDIA     
LIDIA      : MELBA      BUCHANAN   TAMMIE     VANCE      JEANNE     WONG      
CUMMINGS   : DONA       SARA       SANFORD    GILES     
HAWKINS    : THELMA     ANIBAL     DOROTHEA   SAMPSON   
LE         : TYREE      MCCORMICK  ELDON      BLAIR     
ANASTASIA  : CHANG      EDGARDO    PHILLIP   
ROYCE      : YANG       DUNCAN    
BURKS      : ERIN       LENORE     CARR       JESSICA    HARRIET    KRAMER    
FLYNN      : ERICK      NANNIE     JANICE    
DALTON     : TATE       BRUNO     
STRONG     : CANTRELL   HOLCOMB    LEONARD    ANTONIO    SANTANA    FRANKIE   
CLINT      : PECK       BENTON     DICK      
LORNA      : SOLIS      WHITFIELD  NOELLE     PAT       
ENID       : LEACH      BRIAN      HEATH      KATHLEEN   BENTON     JULIET    
JACKSON    : VERA       FARLEY     PARK       RODRIQUEZ 
RICHARDSON : MCCULLOUGH AL         DECKER     SYBIL     
BRYANT     : JUAREZ     LEMUEL     MANNING    MARCEL    
CLEMONS    : CHARLIE    NIKKI      BOBBI     
CHARLENE   : GARRY      WALLER    
ROWE       : CARLSON    HANNAH     OCONNOR    CLARK      MAGGIE     ODOM       TRUDY     
REINALDO   : ABE        LATISHA    JAY        DANIAL    
JOHNNIE    : WOODARD    DANIAL    
TANYA      : DEANA      KOCH       EVANGELINA
COTE       : EMORY      TABATHA    BLAIR     
POOLE      : JARVIS     JONI       HOLT       STACI      MCGOWAN   
ONEIL      : ESTES      LOTTIE     WELLS      GILBERTO   STANLEY   
HELENA     : PHOEBE     GILBERT    ISRAEL     GIOVANNI  
HUBBARD    : FREDDIE    ODOM       VICTOR     DUKE       HUDSON    
MARCEL     : DIONNE     BRYANT     BEASLEY   
BRAY       : TIMOTHY    PAULETTE   LES        ALVAREZ   
DAMON      : WALSH      JIM       
AIDA       : EMILE      PATRICK    DWIGHT    
BLAKE      : PITTMAN    MARGUERITE ANNABELLE 
GEORGIA    : RUTLEDGE  
NELDA      : SILVA      MORENO     ODONNELL   HUNT      
GRAHAM     : RICO       BERNADINE  ALBERT    
HOWARD     : MARTHA     MICHAEL   
STEVENSON  : PERRY      JIMENEZ    GONZALEZ   HEAD      
STACY      : MARCELINO  REFUGIO    ROSALINDA  GLOVER    
CAROL      : AVIS       GRACIELA   INGRAM     ANGELITA  
MADDEN     : MORRIS     ALFREDA    SANCHEZ   
ROSALES    : BALLARD    ROCKY      AVERY      ISIAH      ELVA       JULIET     DARIN      ANDREW    
ROSALES    : ALINE     
ALISSA     : SELENA     NITA       ALFRED    
RODERICK   : CANDICE    TREY      
NOEL       : MARISOL    SYDNEY     THOMAS     MCFADDEN   HURLEY    
MCLEAN     : SUSAN      KERRI     
CONSUELO   : HURLEY     HODGE     
CARLA      : CHANG      FREEMAN    CASSIE    
KASEY      : MCINTYRE  
MORENO     : EVERETT    NELDA     
BARNETT    : BAKER      MALDONADO  GERARDO    TONIA     
ANDREW     : ERIKA      VASQUEZ    KENNEDY    ROSALES   
SAVANNAH   : WILLARD    CARLENE    VALENCIA   KEITH      HURST     
DUNLAP     : HOOPER     JESSIE     MCCORMICK 
MITCHELL   : GRIMES     GOODWIN    JILLIAN   
HEWITT     : DORIS      ISSAC      CROSBY    
BARBRA     : SARA       BUCKLEY    JOSUE      ROJAS     
JOSH       : LESLIE    
MILO       : ROSALIE    LEONARD    ROMAN     
MACK       : WIGGINS    OTIS       SALAZAR    JOHNSTON   HAYDEN    
ODONNELL   : KATHLEEN   GUTHRIE    WILKINSON  NELDA     
JOHNSON    : AVIS       HOUSTON    EMILY      WALL      
MINNIE     : HINTON     ANDREWS    COLEMAN   
CASTRO     : LESTER     ROBLES     SERGIO     AVA        ALEXANDRA  DAVENPORT  BOYLE      DEAN      
JAMEL      : DILLON     DEANA      TAMMY      TRAN      
HOLLOWAY   : MICAH      LEONEL     TERRY      JUAREZ     CORINNE    EVAN      
LANG       : GARRETT   
SALVATORE  : DONA       ROBIN      JASPER    
RANDOLPH   : DORIS      JOHN       DENIS      GILL       COOK       MORROW     ISIDRO     KANE      
TRAVIS     : MAVIS      JENNINGS   WILCOX     NITA       VINCENT    OMAR       JACOB      BRUNO     
DEVON      : EVANGELINA TANNER    
FRANCISCO  : TUCKER     CARLENE    PATEL      ASHLEY     ELVA      
CORRINE    : MCNEIL     BURGESS    BERT       WIGGINS    ROSEANN   
HOGAN      : MIKE       RODRIGUEZ  ORR        ARNULFO    LOTT       HOFFMAN    JOYNER     JOHNSTON  
HOGAN      : NGUYEN    
DANIEL     : DONOVAN    FOWLER     MYERS      QUINTON    CAROLE    
ANGELITA   : FROST      ELOISE     EARNEST    CAROL      MARTIN     DANA      
MARISSA    : DINO       TIMOTHY    WOLFE      ROBBINS    WILLIAMS   DYLAN     
OBRIEN     : JOHNS      CHELSEA    FRIEDA     COTTON     BERNARDO  
WINFRED    : LILA       KLINE      DOYLE      SOLIS      LUPE       VERN       CRAIG     
CLAUDIA    : RODNEY     IGNACIO    BERNARDO  
GIBBS      : HINES      ETTA       BALLARD    ODOM       RICHMOND   MUNOZ      VANCE     
FERRELL    : HART       SEARS      HEATH      ELVIRA     HURST      CAIN      
ELINOR     : LEACH      EARNEST   
LUCY       : WILEY      CORNELIUS 
GAY        : FLETCHER   HEAD      
MOSLEY     : RAMSEY     OCONNOR    SHERYL     HENRIETTA  BENTON    
FUENTES    : CLAYTON    BUDDY      LEVINE     KARLA      ELBERT     DON        MCMAHON   
JULIAN     : NICHOLS    EDGARDO    RUSS       VERNON    
PASQUALE   : COLON      MILAGROS   EARLE     
LEROY      : BENITO    
DELBERT    : ASHLEY     DEWITT     HAYDEN    
DANIAL     : ANNA       STEFANIE   EARL       REINALDO   JOHNNIE    BETH      
PHELPS     : SILAS      TIMOTHY    NANNIE     GOLDIE     FAULKNER   SAUNDERS   SANFORD   
MAYNARD    : JOYCE      OTIS       AURELIA    PAT        BOWEN     
JOYNER     : ABRAHAM    HUGHES     CANTU      HOGAN     
CURTIS     : LORIE      QUINN     
CONSTANCE  : JACKIE     ROBINSON   GUY        MOLINA     ROSEMARY   DANA      
TANNER     : SAMPSON    KEITH      MAXINE     WENDI      DEVON     
KRAMER     : BARRERA    KRISTINA   BOYLE      BURKS     
MCGOWAN    : LELIA      GENARO     POOLE     
SELLERS    : FOSTER     ANTONIA    VICKI     
SHELLEY    : HOOPER     MICAH      BROCK      JEREMY     CAIN      
ALFONSO    : BOB        HAYS       JOHNSTON   KERR       BOWEN     
CROSBY     : HARRINGTON FRANKS     JULIO      PAM        DUKE       CAIN       DEWITT     HEWITT    
PARSONS    : PAULETTE   VERN       CLEVELAND  PUGH       RORY       RAPHAEL   
HELGA      : ODESSA     JORDAN     KERI       RAY        MARCY      CORTEZ     MACIAS    
ALINE      : ROB        BARTLETT   SERGIO     COX        ROSALES    MARTIN    
GALLOWAY   : MERCEDES   PITTS      MCKENZIE   AUSTIN     MARYANNE  
LINDSEY    : MERCEDES   HEBERT     CARSON     HILARIO    KURT      
JOSEPHINE  : GARRETT    ELLIOTT    KELLER    
BERNADINE  : LEE        MERRITT    GRAHAM     RUSSO     
OWEN       : LUISA      GATES     
CASEY      : KENDALL    SHEPARD    MERLE     
TYLER      : COMBS      HILARIO    VICTORIA  
MARCIA     : ISABELLE   WEEKS      NIKKI      BRIGGS    
COLLINS    : GUY        AUGUSTINE  KIP        AMADO     
MONROE     : STEELE     RONALD    
MARVIN     : JACLYN     CARMELO   
DUFFY      : ANNA       LUCIANO    GUTHRIE    TOMMY      WALLER     SIMPSON    JOHNSTON  
JOHNSTON   : CARLSON    ELLIS      PORTER     DAREN      MACK       HOGAN      ALFONSO    DUFFY     
KELLY      : BOBBIE     BUCKLEY   
RUSSO      : ANNA       MERCADO    JOYCE      MARIANA    ARNULFO    BERNADINE 
BRIDGET    : JULIO      MCCALL     ESTEBAN   
LYNN       : VELASQUEZ  BRIAN      NAVARRO    KERRI     
BEASLEY    : MCCARTHY   ROSEMARY   GONZALES   MARCEL    
ETHEL      : DEWAYNE    LESSIE    
MACIAS     : OLIVER     FRANCESCA  PARK       COFFEY     HELGA     
FINLEY     : MCKENZIE   NEAL       MANUEL     DENA       NORA       NATASHA   
BARTON     : ABRAHAM    FOREST     SILAS      BASIL     
RUSSEL     : WITT       LEACH      CRAFT      RAPHAEL   
PALMER     : SANTIAGO   HAYS       CATHRYN   
GLOVER     : LESLIE     BUCK       HIGGINS    STACY     
LAWANDA    : ISSAC      BERNADETTE EVANGELINE TONIA     
EVE        : BERTIE     ALVAREZ    LACY       AMADO     
GILBERTO   : DIAZ       FULLER     ONEIL      POLLARD   
LLOYD      : TODD       VICKY      SHARON     JEAN       RENA      
HEAD       : CHAN       DUSTY      STEVENSON  GAY       
PARKS      : BARRY      EMORY      BETHANY   
MARTIN     : WITT       FULTON     ANGELITA   ALINE     
SAVAGE     : GABRIELA   HARMON     CHARMAINE 
MAURICE    : HOLT       HARMON     ROSALINDA 
STEPHENSON : PITTMAN    ALTA       BREWER    
NICHOLSON  : MARIE      JERALD     PEREZ      GREENE     HARPER    
BRIGGS     : ERICKA     MARCIA    
REYNOLDS   : LENORA    
REILLY     : TORRES    
EVANGELINE : WEBSTER    CLAY       WHITFIELD  LAWANDA   
BRYAN      : ADAM       RONALD     BURCH      VERN       FRANKIE   
NGUYEN     : MARSH      HOGAN      TY        
WEBB       : CECIL      ADAM       RODRIQUEZ 
ROTH       : PHILLIPS   MARCUS     JESSE      BRADSHAW   BOWMAN     CAIN      
KANE       : MONICA     MARGARITA  RANDOLPH  
ALBERT     : TRENTON    SUAREZ     GRAHAM    
LESSIE     : LESTER     MARA       ERICKA     ETHEL     
ANGIE      : DENIS      TOWNSEND   BLAIR      LENORA    
DEAN       : LULU       ELDON      ELLIOTT    MAYER      CASTRO     FRANKLIN  
MCCLURE    : KENNEDY    MELBA     
STANLEY    : VALERIE    CHAN       CLAY       SAMUEL     BOBBI      CHRISTIAN  ONEIL     
MCBRIDE    : LOGAN     
HUNT       : STEVEN     NELDA     
BETH       : BETTE      GOOD       DANIAL    
RENA       : KENT       VICTOR     LLOYD      BAUER     
ROBERTSON  : FROST      ELIZA      JERALD     GOLDIE     SHEPHERD  
KEVIN      : VICTOR     SOSA       RAUL      
KRYSTAL    : COLON     
WELDON     : KYLE      
ESTRADA    : TRENTON    WHITLEY    HORN       GEORGE    
GREENE     : CONCEPCION EARLE      NICHOLSON 
MCMAHON    : KNOWLES    MARCI      TATE       NANCY      ALYSON     FUENTES   
TRENT      : BARRY      PIERCE     CURRY     
REGINA     : SYDNEY     LAUREN    
POLLARD    : OSCAR      PHILLIPS   DARCY      MICHEAL    FOREMAN    GILBERTO  
QUINTON    : FRYE       DANIEL    
CAROLE     : VELASQUEZ  CONLEY     BOWERS     VALENTINE  DANIEL    
HOLLAND    : WILLARD    DILLON     SHARON    
KERR       : HOLMAN     BRADSHAW   ALFONSO   
DARRYL     : DAWN       CONRAD    
CHARLES    : RICARDO    PRESTON   
LOGAN      : HARDY      FLEMING    MUNOZ      MCBRIDE   
CASSIE     : MCCARTHY   BAKER      ROBINSON   THURMAN    FOREMAN    RUSS       CARLA     
BOWEN      : ISRAEL     BEST       NIKKI      MAYNARD    ALFONSO   
HARPER     : NICHOLSON 
FRANKLIN   : PETTY      PECK       HUBER      WOODARD    ERNA       DEAN      
WONG       : CATHRYN    ERNIE      LIDIA     
MERRILL    : BRIAN      KATHLEEN  
MONA       : SAM        BLEVINS    MARIBEL    CORTEZ    
TONIA      : PAYNE      WILKERSON  BARNETT    LAWANDA   
DANA       : JOHNATHAN  LYDIA      ISABELLE   ART        ANGELITA   CONSTANCE 
ANNABELLE  : WILCOX     SHAWN      LOWE       MEADOWS    BLAKE     
TY         : MARK       ZAMORA     GLASS      GOLDIE     NGUYEN    
HILL       : DONOVAN    MAE       
BAUER      : ISSAC      CHARLIE    ERICK      KRISTEN    RENA      
TRACY      : JAIME      RITA      
HAYDEN     : JANETTE    AVA        ERICKSON   BRADFORD   MACK       DELBERT   
NATASHA    : GARRETT    EVERETT    FINLEY    
RAUL       : STEPHENS   ROBBIE     MARCI      AHMED      STANTON    KEVIN     
VAUGHN     : MARIANA    RANDALL   
LORAINE    : LETITIA    MCCARTHY   LENORA    
RACHAEL    : BELL       CHRISTA    DAPHNE     GERARDO    FERN       TERENCE   
SHERRI     : BRADFORD  
PETERSEN   : LEVI       MCCARTHY   COOLEY     MEDINA     MILLER     DUSTY      ERICKA     SHARON    
